A	AH
A(2)	EY
A3TSO	EY TH R IY T IY EH S OW
AANG	AA NG
AANIHIN	AA N AH HH AH N
AAWAY	AH AH W EY
AB	AE B
ABAG	AH B AE G
ABAGA	AE B AH G AH
ABAGAHON	AH B AE G AH HH AH N
ABAKA	AE B AH K AH
ABAKADA	AH B AE K AH D AH
ABALO	AE B AH L OW
ABANA	AE B AH N AH
ABANDONA	AH B AE N D AH N AH
ABANG	AH B AE NG
ABANGAN	AH B AE N G AH N
ABANO	AE B AH N OW
ABANTE	AE B AH N T
ABE	EY B
ABENTURA	AH B EH N T Y AH R AH
ABI	AE B IY
ABILIDAD	AH B IH L AH D AH D
ABIS	AH B AY Z
ABISO	AE B AH S OW
ABLIHAN	AE B L AH AH N
ABLIHI	AE B L AH HH IY
ABO	AA B OW
ABOG	AH B AO G
ABOGADO	AH B AO G AH D UW
ABOGADOGIHADLOK	AH B AH G AE D AH JH AH HH AE D L AH K
ABOHAN	AE B AH AH N
ABOHON	AE B AH HH AH N
ABONO	AE B AH N OW
ABORSYON	AH B IY ER Z IY AO N
ABOT	AE B AH T
ABRI	AE B R IY
ABRIL	AH B R IH L
ABROD	AE B R AH D
ABTANAN	AE B T AH N AH N
ABTIK	AE B T AH K
ABUG	AH B AH G
ABUHON	AE B AH HH AH N
ABUNDA	AH B AH N D AH
ABUSO	AE B Y UW S OW
ABUT	AH B AH T
ABUTAN	AE B Y UW T AH N
ACCESS	AE K S EH S
ACCOMPANY	AH K AH M P AH N IY
ACCOUNTING	AH K AW N T IH NG
ACCOUNTING(2)	AH K AW N IH NG
ACT	AE K T
AD	AE D
ADDRESS	AE D R EH S
ADIK	AE D AH K
ADJUST	AH JH AH S T
ADLAW	AE D L AH
ADLAWA	AE D L AH AH
ADLAWAN	AE D L AH AH N
ADLAWNG	AE D L AH NG
ADLAWON	AE D L AH AH N
ADMINISTRASYON	AE D M AH N AH S T R AE S AY AH N
ADMIRE	AE D M AY R
ADMIT	AH D M IH T
ADOBO	AE D AH B OW
ADONIS	AH D AA N AH S
ADOPT	AH D AA P T
ADORNO	AA D AO R N OW
ADRES	AE D AH R Z
ADTO	AE D T OW
ADTOANAN	AE D T OW N AH N
ADTOON	AE D T UW N
ADTUAN	AE D T Y UW AH N
ADUNA	AE D Y UW N AH
ADUNAY	AE D Y UW N EY IY
ADV	AE D
ADVANCE	AH D V AE N S
ADVERTISE	AE D V ER T AY Z
ADVERTISING	AE D V ER T AY Z IH NG
ADVISE	AE D V AY Z
ADVISE(2)	AH D V AY Z
AFRAID	AH F R EY D
AFRICA	AE F R IH K AA
AFRICAN	AE F R IH K AA N
AFRITADA	AE F R IH T AH D AH
AG	AE G
AG(2)	EY G IY
AGA	AA G AH
AGAD	AH G AE D
AGAIN	AH G EH N
AGAIN(2)	AH G EY N
AGALON	EY JH AH L AO N
AGAS	AH G AE S
AGAW	AE G AH
AGAWON	AE G AH AH N
AGBAY	AE G EY IY
AGDAO	AE G D EY OW
AGENCY	EY JH AH N S IY
AGENDA	AH JH EH N D AH
AGENT	EY JH AH N T
AGER	EY JH ER
AGI	AE JH IY
AGIANAN	EY JH IY AH N AH N
AGIG	AH G IH G
AGIGISING	AH G IH G IY Z IH NG
AGION	EY JH AH N
AGIPO	AE JH AH P OW
AGIW	AE JH AH W
AGNI	AE G N IY
AGOSTO	AA G OW S T OW
AGOT	AH G AA T
AGOY	AH G OW IY
AGREE	AH G R IY
AGREEMENT	AH G R IY M AH N T
AGRESIBO	AE G R EH S AH B OW
AGRIKULTURA	AE G R AH K AH L T Y AH R AH
AGSA	AE G S AH
AGTANG	AE G T AH NG
AGUSTO	AH G AH S T OW
AGWANTAHON	AE G W AA N T AH HH AH N
AHAK	AE HH AH K
AHAS	AE HH AH Z
AHAY	AH HH EY
AHENSYA	AH HH EH N S AY AH
AHENTE	AE HH AH N T
AHOS	AE HH AH Z
AID	EY D
AIDS	EY D Z
AIR	EH R
AIRPLANE	EH R P L EY N
AIRPORT	EH R P AO R T
AIZA	EY Z AH
AKA	AA K AH
AKA(2)	EY K EY EY
AKADEMIKO	AE K AH D EH M AH K OW
AKO	AE K OW
AKOA	AE K OW AH
AKOG	AE K AH G
AKOHON	AE K AH HH AH N
AKONG	AE K AH NG
AKOY	AE K OW IY
AKRHO	AE K R OW
AKSENTO	AE K S EH N T OW
AKSESORI	AE K S EH S AH R IY
AKSIDENTE	AE K S AH D AH N T
AKSIDENTING	AE K S AH D EH N T AH NG
AKSYON	AE K S AY AH N
AKTIBISTA	AE K T AH B IH S T AH
AKTIBO	AE K T AH B OW
AKTO	AE K T OW
AKUP	AE K AH P
AKWARYUM	AE K W AE R AY AH M
ALA	AE L AH
ALA(2)	EY L AH
ALAB	AH L AE B
ALAGIAN	EY L AH JH AH N
ALAHAS	AE L AH HH AH Z
ALAK	AE L AH K
ALAM	AH L AE M
ALAMBRE	AH L AE M B AH R
ALANG	AE L AH NG
ALARMA	AH L AA R M AH
ALAS	AH L AE S
ALAUT	AE L AH T
ALBOTRA	AE L B AA T R AH
ALBUM	AE L B AH M
ALCOY	AE L K OW IY
ALEMAN	EY L M AH N
ALFREDO	AE L F R EY D OW
ALI	AA L IY
ALIAS	EY L IY AH S
ALIBANG	AE L AH B AH NG
ALIBANGBANG	AE L AH B AE N G AH NG
ALIBWAG	AH L IH B W AH G
ALIBYO	AH L IH B AY OW
ALILI	AE L AH L IY
ALIMANGO	AE L AH M AE N G OW
ALIMPULO	AE L AH M P Y UW L OW
ALIMPULOS	AE L AH M P Y UW L AH Z
ALIMUOT	AH L IH M Y UW AH T
ALINDAHAW	AH L IH N D AH HH AH
ALINDUM	AH L IH N D AH M
ALINGASA	AH L IH N G AH S AH
ALINGAWNGAW	AE L AH N G AO N G AH
ALIRONG	AE L AH R AH NG
ALISDAN	AH L IH Z D AH N
ALISTO	AH L IH S T OW
ALIWAROS	AH L IH W AH R AH Z
ALKOBA	AE L K AH B AH
ALKOHOL	AE L K AH HH AH L
ALLAN	AE L AH N
ALLOTMENT	AH L AA T M AH N T
ALMS	AA L M Z
ALMS(2)	AA M Z
ALMUHADON	AE L M AH HH AH D AH N
ALNGOG	AE L N G AH G
ALOM	AE L AH M
ALPOMBRA	AE L P AA M B R AH
ALTAR	AO L T ER
ALTERNATIBO	AE L T AH R N AE T AH B OW
ALUMINUM	AH L UW M AH N AH M
ALVIN	AE L V IH N
ALYANSA	AE L AY AE N S AH
ALYAS	AE L AY AH Z
AM	AE M
AM(2)	EY EH M
AMADOR	AE M AH D AO R
AMAHAN	AE M AH AH N
AMAHANG	AE M AH HH AH NG
AMAHON	AE M AH HH AH N
AMAKAN	AE M AH K AH N
AMAW	AH M AO
AMBAHADOR	AE M B AE HH AH D AH R
AMBAK	AE M B AH K
AMBOT	AE M B AH T
AMBULANSIYA	AE M B Y UW L AH N S IY AY AH
AMBUSANAN	AE M B Y UW S AH N AH N
AMBUSH	AE M B UH SH
AMERICAN	AH M EH R IH K AH N
AMERIKA	AH M EH R IH K AH
AMERIKANA	AE M AH R IH K AH N AH
AMERIKANO	AE M AH R IH K AH N OW
AMGO	AE M G OW
AMIGA	AH M IY G AH
AMIGO	AH M IY G OW
AMIGOS	AH M IY G OW Z
AMIHAN	AE M AH AH N
AMIHANAN	AH M IH HH AH N AH N
AMIMISLON	AE M AH M IH Z L AH N
AMIN	AA M IY N
AMIRKANO	AH M AH R K AH N OW
AMO	AA M OW
AMON	AA M AO N
AMONG	AH M AH NG
AMOT	AE M AH T
AMPING	AE M P AH NG
AMPINGAN	AE M P IH N G AH N
AMPO	AE M P OW
AMULET	AE M Y AH L AH T
AN	AE N
AN(2)	AH N
ANA	AA N AH
ANA(2)	AE N AH
ANAA	AE N AH
ANAAY	AE N AH IY
ANAD	AE N AH D
ANAK	AE N AH K
ANALISA	AH N AE L AH S AH
ANALISTA	AE N AH L IH S T AH
ANAN	EY N AH N
ANANG	AE N AH NG
ANAY	AE N EY IY
ANCESTORS	AE N S EH S T ER Z
ANCY	AE N S IY
AND	AH N D
AND(2)	AE N D
ANDAM	AE N D AH M
ANDAMON	AE N D AH M AH N
ANDANA	AE N D AH N AH
ANDRES	AA N D R EY Z
ANDRES(2)	AE N D R EY Z
ANEMYA	AH N EH M AY AH
ANG	AE NG
ANGAN	AE N G AH N
ANGAY	AE N G EY IY
ANGAYAN	AE N G EY AH N
ANGELITA	AA NG G EH L IY T AH
ANGGA	AE N G AH
ANGGULO	AE N G Y UW L OW
ANGHEL	AE N AH L
ANGHIT	AE N AH T
ANGKAS	AE N G K AH Z
ANGKAT	AE N G K AH T
ANGKON	AE N G K AH N
ANGLIT	AE N G L AH T
ANGRY	AE NG G R IY
ANGSO	AE N G S OW
ANGTOD	AE N G T AH D
ANHA	AE N HH AH
ANHI	AE N HH IY
ANI	AE N IY
ANIA	EY N Y AH
ANIBERSARYO	AE N AH B AH R S AE R AY OW
ANIBIRSARYU	AE N AH B AH R S AE R AY UW
ANIHON	AE N AH HH AH N
ANIHUN	AE N AH HH AH N
ANIMAL	AE N AH M AH L
ANING	AE N IH NG
ANINIKAD	AH N IH N AH K AH D
ANINO	AE N AH N OW
ANKLE	AE NG K AH L
ANO	AE N OW
ANO(2)	AE N Y OW
ANON	AE N AH N
ANONG	AE N AH NG
ANOY	AE N OW IY
ANTARCTIC	AE N T AA R K T IH K
ANTARCTIC(2)	AE N AA R T IH K
ANTENNA	AE N T EH N AH
ANTEPARA	AE N T EH P AH R AH
ANTEYOHOS	AE N T EY AH HH AH Z
ANTHEM	AE N TH AH M
ANTHONY	AE N TH AO N IY
ANTIKRISTO	AE N T AY K R IH S T OW
ANTOS	AA N T OW Z
ANTUS	AE N T AH S
ANUGON	AE N Y UW G AH N
ANUOS	AE N Y UW AH Z
ANYAG	AE N AY AH G
ANYIL	AE N AY AH L
ANYOS	AE N AY AH Z
ANYWAY	EH N IY W EY
AP	AE P
APA	AE P AH
APALAN	AE P AH L AH N
APAN	AH P AE N
APARADOR	AH P AH R EY D ER
APARATO	AH P AE R AH T OW
APARTMENT	AH P AA R T M AH N T
APDU	AE P D UW
APEKTO	AH P EH K T OW
APELAR	AH P EH L ER
APENDIKS	AH P EH N D AH K S
APIL	AE P AH L
APILON	AE P AH L AH N
APING	EY P IH NG
APLAYAN	AE P L EY AH N
APLIKANTE	AE P L AH K AH N T
APLIKASYON	AE P L AH K AE S AY AH N
APO	AE P OW
APOD	AH P AA D
APOHAN	AE P AH AH N
APOLOGY	AH P AA L AH JH IY
APOSTOL	AE P AO S T AH L
APPETITE	AE P AH T AY T
APPLY	AH P L AY
APPOINTMENT	AH P OY N T M AH N T
APUGON	AH P AH G AO N
ARABO	AE R AH B OW
ARABYANO	AE R AH B AY AH N OW
ARANG	AH R AE NG
ARAW	AH R AO
ARCILLA	AA R S IH L AH
AREA	EH R IY AH
ARESTO	AH R EH S T OW
ARGAO	AA R G EY OW
ARGAW	AA R G AH
ARGUMENTO	AA R G Y AH M EH N T OW
ARI	AA R IY
ARINOLA	AH R IH N AH L AH
ARITES	AH R AY T S
ARITMATIKA	AE R AH T M AE T AH K AH
ARJUN	AA R JH AH N
ARKA	AA R K AH
ARKANGHEL	AA R K AH N AH L
ARKITEKTO	AA R K AH T EH K T OW
ARKITIKTURA	AA R K AH T IH K T Y AH R AH
ARMADO	AA R M AH D UW
ARMAS	AA R M AH Z
ARMPIT	AA R M P IH T
AROGANTE	AE R AH G AH N T
ARON	EH R AH N
ARREST	ER EH S T
ARRIVAL	ER AY V AH L
ARS	AA R Z
ARSENIO	AA R S IY N IY OW
ARSOBISPO	AA R S AH B IH S OW
ARTAASTANG	AA R T AA S T AH NG
ARTE	AA R T
ARTIKULO	AA R T AH K Y UW L OW
ARTISTA	AA R T IH S T AH
ARTISTANG	AA R T IY Z T AE NG
ARTISTIC	AA R T IH S T IH K
ARTISTOKRATA	AA R T AH S T AA K R AH T AH
AS	AE Z
AS(2)	EH Z
ASA	AA S AH
ASAWA	AE S AH AH
ASAYNMENT	AH S EY N M AH N T
ASERO	AE S AH R OW
ASGAD	AH Z G AE D
ASHAMED	AH SH EY M D
ASIDO	AE S AH D OW
ASIKASO	AH S IH K AH S OW
ASIN	AH S IH N
ASK	AE S K
ASO	AE S OW
ASON	AH S AH N
ASOY	AH S OY
ASPALTO	AE S AE L T OW
ASPARAGUS	AH S P EH R AH G AH S
ASPERA	AE S AH R AH
ASPETO	AE S AH T OW
ASSAULT	AH S AO L T
ASSET	AE S EH T
ASSIST	AH S IH S T
ASSURE	AH SH UH R
ASTA	AA S T AH
ASTHMA	AE Z M AH
ASU	AE S UW
ASUGI	AH S UW JH IY
ASUKAL	AH S UW K AH L
ASUKAR	AH S UW K AH R
ASUL	AE S AH L
ASUMIR	AH S UW M AH R
ASUPRE	AH S UW P AH R
ASYA	AE S AY AH
ASYANHONON	AE S AY AE N HH AH N AH N
ASYANO	AH S AY AH N OW
ASYENDA	AE S AY EH N D AH
AT	AE T
ATABAY	AH T AE B EY IY
ATAKE	AH T EY K
ATAN	AH T AE N
ATAY	AE T EY IY
ATBANG	AE T B AH NG
ATENSYON	AH T EH N S IY AO N
ATHLETE	AE TH L IY T
ATIK	AE T AH K
ATIMAN	AE T AH M AH N
ATIMANON	AH T IH M AH N AH N
ATIS	EY T IY Z
ATLETA	AE T L AH T AH
ATLETIKO	AE T L EH T AH K OW
ATNGAL	AE T N G AH L
ATO	AE T OW
ATOL	AE T AH L
ATOMO	AE T AH M OW
ATON	AH T AA N
ATONG	AH T AA NG
ATOP	AH T AA P
ATRAKSIYON	AE T R AH K S IY AY AH N
ATRAS	AE T R AH Z
ATSAL	AE T S AH L
ATSARA	AE T S AH R AH
ATTACK	AH T AE K
ATTEMPT	AH T EH M P T
ATTENDANT	AH T EH N D AH N T
ATTY	AE T IY
ATUBANGAN	AE T Y AH B AE N G AH N
ATUBANGON	AE T Y AH B AE N G AH N
ATULI	AE T Y AH L IY
ATUP	AE T AH P
AURORA	ER AO R AH
AVE	AA V EY
AVENTURADO	AE V AH N T Y UH R AH D OW
AVERAGE	AE V ER IH JH
AVERAGE(2)	AE V R IH JH
AVILA	AH V IH L AH
AVIS	EY V IH S
AVISO	AE V AH S OW
AVOID	AH V OY D
AW	AO
AWA	AO AH
AWAG	AH W AE G
AWAHI	AO AH HH IY
AWANG	AO AH NG
AWARENESS	AH W EH R N AH S
AWAS	AO AH Z
AWAT	AO AH T
AWAY	AH W EY
AWIT	AH W IH T
AWKWARD	AA K W ER D
AWKWARD(2)	AO K W ER D
AWON	AH W AH N
AWTO	AO T OW
AWTOMATIKO	AO T AH M AE T AH K OW
AWTORIDAD	AH T AO R AH D AH D
AY	EY
AY(2)	AY
AYAG	EY AH G
AYAW	AH Y AO
AYAWG	EY AH G
AYAY	EY EY IY
AYHA	EY HH AH
AYO	EY OW
AYOS	EY AH Z
AYROPLANO	EY R AA P L AH N OW
AYS	EY Z
AYUHON	EY AH HH AH N
BA	B AA
BABA	B AH B AH
BABA(2)	B AA B AH
BABAAN	B AE B EY AH N
BABAE	B AE B IY
BABAG	B AE B AH G
BABAGAN	B EY B AH JH AH N
BABAW	B AE B AH
BABAY	B AE B EY IY
BABAYE	B AE B EY
BABAYI	B AE B EY IY
BABOY	B AE B OW IY
BACALSO	B AH K AE L S OW
BACHELOR	B AE CH AH L ER
BACHELOR(2)	B AE CH L ER
BACKGROUND	B AE K G R AW N D
BACKSEAT	B AE K S IY T
BACOLOD	B AE K AH L AH D
BACON	B EY K AH N
BAD	B AE D
BADAYOS	B AE D EY AH Z
BADBAD	B AE D B AE D
BADLONG	B AE D L AO NG
BADLONGON	B AE D L AO NG AO N
BADYET	B AE D AY AH T
BAG	B AE G
BAGA	B AE G AH
BAGAHAN	B AE G AH AH N
BAGAHE	B AE G AH HH
BAGAKAY	B AH G AE K EY IY
BAGAT	B AE G AH T
BAGAY	B AE G EY IY
BAGIS	B AE G IY Z
BAGITO	B AE JH AH T OW
BAGKUS	B AE G K AH S
BAGO	B AE G OW
BAGOL	B AE G AH L
BAGOLBAGOL	B AH G OW L B AH G AH L
BAGON	B AE G AO N
BAGONG	B AE G AH NG
BAGONYA	B AH G AA N AY AH
BAGSAK	B AE G S AH K
BAGTAK	B AE G T AH K
BAGTING	B AE G T AH NG
BAGTINGON	B AE G T IH N G AH N
BAGUIO	B AE G W IY OW
BAGUL	B AE G AH L
BAGUTBUT	B AH G AH T B AH T
BAGYO	B AE JH AY OW
BAGYUHON	B AH JH AY AH HH AH N
BAHA	B AE HH AH
BAHALA	B AE HH AH L AH
BAHANDI	B AH HH AE N D IY
BAHAW	B AE HH AH
BAHAY	B AE HH EY IY
BAHIHI	B AE HH AH HH IY
BAHIN	B AE HH AH N
BAHINAN	B AE HH AH N AH N
BAHINON	B AE HH AH N AH N
BAHO	B AE HH OW
BAHONG	B AE HH AH NG
BAIL	B EY L
BAIWAS	B EY W AH Z
BAKA	B AA K AH
BAKAK	B AE K AH K
BAKAKON	B AE K AH K AH N
BAKANTE	B AE K AH N T
BAKASYON	B AH K AE S AY AH N
BAKEL	B AE K AH L
BAKERY	B EY K ER IY
BAKHAW	B AE K AH
BAKHO	B AE K OW
BAKI	B AE K IY
BAKIKAW	B AE K AH K AH
BAKIT	B AE K AH T
BAKLI	B AE K L IY
BAKOD	B AE K AH D
BAKSAN	B AE K S AH N
BAKUKANG	B AE K Y UW K AH NG
BAKUNA	B AE K Y UW N AH
BAKUNAHAN	B AE K Y UW N AH AH N
BAKUS	B EY K AH S
BAKWION	B AE K W IY AH N
BALA	B AA L AH
BALAAN	B AE L EY AH N
BALAANON	B AE L AH N AH N
BALABAG	B IY AH L AH B AE G
BALAKANG	B AE L AH K AH NG
BALAMBAN	B AH L AE M B AH N
BALANGAY	B AH L AE N G EY IY
BALANSE	B AE L AH N S
BALANTIYONG	B AE L AH N T IY AY AH NG
BALAOD	B AE L EY AH D
BALAODNON	B AE L EY AA D N AH N
BALAS	B AE L AH S
BALAT	B AE L AH T
BALAUD	B AE L AH D
BALAURANAN	B AH L AO R AH N AH N
BALAY	B AE L EY IY
BALBACOA	B AE L B AE K OW AH
BALDADO	B AO L D AH D UW
BALDE	B AE L D
BALDI	B AA L D IY
BALE	B EY L
BALI	B AA L IY
BALIGUAT	B AH L IH G W AH T
BALIGYA	B AH L IH JH AY AH
BALIGYAANAN	B AE L AH JH AY AH N AH N
BALIHA	B AE L AH HH AH
BALIK	B AA L IH K
BALIKA	B AE L AH K AH
BALIKBALIK	B AH L IH K B AH L AH K
BALIKI	B AE L AH K IY
BALIKO	B AE L AH K OW
BALIKTAD	B AH L IH K T AH D
BALILI	B AE L AH L IY
BALILIHAN	B AH L IH L AH AH N
BALINGBING	B EY L IH NG B IY IH NG
BALITA	B AE L AH T AH
BALITANG	B AE L AH T AH NG
BALITI	B AE L AH T IY
BALKON	B AO K AO N
BALKONAHE	B AE L K AH N AH HH
BALO	B AE L OW
BALOR	B EY L ER
BALSAMO	B AA L S AA M OW
BALUD	B AE L AH D
BALUS	B EY L AH S
BALUWARTE	B AE L AH W AH R T
BALYENA	B AH L AY AH N AH
BANA	B AE N AH
BANABANA	B AH N AE B AH N AH
BANAGAN	B EY N AH JH AH N
BANAGBANAG	B AH N AE G AH N AH G
BANAY	B AE N EY IY
BANAYNG	B AH N EY NG
BANDA	B AE N D AH
BANDERA	B AE N D IH R AH
BANDILA	B AE N D AH L AH
BANDYO	B AE N D AY OW
BANG	B AE NG
BANGAS	B AE N G AE S
BANGAW	B AE N G AH
BANGGA	B AE N G AH
BANGGAAN	B AE N G EY AH N
BANGGIRA	B AE N JH AH R AH
BANGGITIN	B AE N JH AH T AH N
BANGKAW	B AE N G K AH
BANGKETE	B AE N G K IY T
BANGKO	B AE N G K OW
BANGOY	B AE N G OW IY
BANGTUD	B AE N G T AH D
BANGUS	B AE N G AH S
BANHAAN	B AE N HH EY AH N
BANI	B AE N IY
BANIG	B AE N AH G
BANIKANHON	B AE N AH K AE N HH AH N
BANILAD	B AE N AH L AH D
BANK	B AE NG K
BANKRUPT	B AE NG K R AH P T
BANLAG	B AE N L AE G
BANOG	B AE N AH G
BANOS	B AA N OW Z
BANSIKOL	B AE N S AH K AH L
BANSILAG	B AE N S AH L AH G
BANSIWAG	B AE N S AH W AH G
BANTAAW	B AE N T AH W
BANTANG	B AE N T AE NG
BANTAY	B AE N T EY IY
BANTAYAN	B AE N T EY AH N
BANTAYANAN	B AE N T EY AH N AH N
BANTING	B IY AH N T IH NG
BANTOG	B AE N T AA G
BANTOGAN	B AE N T AH G AH N
BANTUG	B AE N T AH G
BANTUGAN	B AE N T Y UW G AH N
BANYAGA	B AH N AY AH G AH
BANYO	B AE N AY OW
BAO	B AW
BAPOR	B EY P AH R
BAR	B AA R
BARA	B AA R AH
BARADO	B AA R AH D UW
BARAHA	B AE R AH HH AH
BARANDILYAS	B AE R AH N D IH L AY AH Z
BARANG	B AE R AH NG
BARANGAY	B AH R AE N G EY IY
BARATILYO	B AE R AH T IH L AY OW
BARATO	B AE R AH T OW
BARATONG	B AA R AH T AA NG
BARBARIAN	B AA R B EH R IY AH N
BARBAS	B AA R B AH Z
BARBER	B AA R B ER
BARCELITO	B AA R S EH L AH T OW
BARGAIN	B AA R G AH N
BARGAIN(2)	B AA R G IH N
BARGAMENTO	B AA R G AH M EH N T OW
BARIL	B EH R AH L
BARILIS	B IY EH R IY L IY Z
BARILON	B AA R IH L AO N
BARITONO	B AH R IH T AH N OW
BARKADA	B AA R K AH D AH
BARKO	B AA R K OW
BARONG	B AE R AH NG
BAROTO	B AE R AH T OW
BARUG	B AE R AH G
BARUGANAN	B AH R UW G AH N AH N
BARYO	B AE R AY OW
BAS	B AE Z
BASA	B AA S AH
BASABASA	B AH S AE B AH S AH
BASAG	B AE S AH G
BASAHA	B AE S AH HH AH
BASAHON	B AE S AH HH AH N
BASAK	B AE S AH K
BASAKAN	B AE S AH K AH N
BASE	B EY S
BASEBALL	B EY S B AO L
BASEMENT	B EY S M AH N T
BASI	B AA S IY
BASI(2)	B EY S IY
BASIHAN	B AE S AH AH N
BASIHANAN	B AH S IH HH AH N AH N
BASILIKA	B AH S IH L AH K AH
BASIN	B EY S AH N
BASKETBALL	B AE S K AH T B AO L
BASKETBOLAN	B AE S EH T B AH L AH N
BASKETBOLISTA	B AE S EH T B AH L IH S T AH
BASKITBOL	B AE S IH T B AH L
BASO	B AE S OW
BASOL	B AE S AH L
BASTA	B AE S T AH
BASTARD	B AE S T ER D
BASTES	B EY S T S
BASTOS	B AE S T AA S
BASURA	B AE S AH R AH
BAT	B AE T
BATA	B AE T AH
BATAA	B AE T AH
BATAK	B AE T AH K
BATAKA	B AE T AH K AH
BATAKAN	B AE T AH K AH N
BATALYON	B EY T AH L IY AO N
BATAN	B EY T AH N
BATANG	B AE T AH NG
BATANON	B AE T AH N AH N
BATAON	B AE T AH AO N
BATAS	B AE T AH Z
BATASAN	B AE T AH Z AH N
BATCHOY	B AE CH OW IY
BATERYA	B AH T EH R AY AH
BATHROOM	B AE TH R UW M
BATI	B AE T IY
BATID	B EY T AH D
BATIIS	B EY T IY IY Z
BATIKULON	B AE T AH K Y UW L AH N
BATINGGOL	B AH T IH N G AH L
BATO	B AE T OW
BATOK	B AE T AH K
BATONG	B AE T AH NG
BATONIS	B AE T AA N IY Z
BATOON	B AH T UW N
BATSILYERATO	B AE T S AH L AY EH R AH T OW
BATTLE	B AE T AH L
BATUTA	B AE T Y UW T AH
BAUL	B AO L
BAWION	B AO IY AH N
BAWNDERI	B AO N D AH R IY
BAWOT	B AO AH T
BAWUNO	B AO UW N OW
BAY	B EY
BAYABAS	B EY AH B AH Z
BAYAD	B EY AH D
BAYAN	B EY AH N
BAYANAN	B EY AH N AH N
BAYANI	B EY AH N IY
BAYANING	B EY EY N AH NG
BAYARI	B EY AH R IY
BAYAW	B EY AH
BAYAY	B EY EY IY
BAYBAY	B EY B EY
BAYBAYON	B EY B EY AO N
BAYHANA	B EY HH AH N AH
BAYLE	B EY L
BAYLEHANAN	B EY L EH HH AH N AH N
BAYLO	B EY L OW
BAYNTE	B EY N T
BAYNTISINGKO	B EY N T AH S IH N G K OW
BAYOLET	B EY AH L AH T
BAYOT	B EY AH T
BAYRAN	B EY R AE N
BAYRANAN	B EY R AH N AH N
BAYRONON	B EY R AH N AH N
BEACH	B IY CH
BEAN	B IY N
BEAUTIFUL	B Y UW T AH F AH L
BEBE	B IY B IY
BED	B EH D
BEDEW	B IH D UW
BEDROOM	B EH D R UW M
BEER	B IH R
BEHIND	B IH HH AY N D
BEISBOL	B AH IH Z AH L
BELBEL	B EH L B EH L
BELEN	B EH L AH N
BELOS	B EH L AA S
BEN	B EH N
BENDAHE	B IH N D AE HH
BENDISYON	B EH N D IY Z IY AO N
BENIYAAN	B AH N AY AY EY AH N
BENTAHA	B IH N T AE HH AH
BENTANA	B IH N T AE N AH
BENTILADOR	B IY AH N T AY L EY D ER
BERDE	B IH R D IY
BERETA	B IH R AH T AA
BERNING	B ER N IH NG
BERTO	B IH R T OW
BESES	B IY Z IH Z
BEST	B EH S T
BETA	B EY T AH
BETANYA	B AH T AE N AY AH
BETERANO	B AH T EH R AH N OW
BETERINARYO	B AH T EH R AH N AE R AY OW
BETSY	B EH T S IY
BEVERAGE	B EH V ER IH JH
BEVERAGE(2)	B EH V R IH JH
BEYER	B EY ER
BIBIG	B AY B IH G
BIBIGYAN	B AY B AH JH AY AH N
BIBINGKA	B AY B AY N G K AA
BIBLIOGRAPIYA	B AY B L AY AA G R AH P IY AY AH
BIBLIYA	B AY B L AY AY AH
BIBO	B AY B OW
BIDA	B AY D AA
BIGAON	B IH G AH AO N
BIGOTE	B AY G OW T
BIHAG	B AY HH AE G
BIKARBONATO	B AY K AA R B AA N AH T OW
BIKO	B IY K OW
BIKTIMA	B AY K T IH M AH
BILANGGOAN	B AY L AE N G OW AH N
BILAS	B AY L AE Z
BILAT	B AY L AE T
BILDING	B IH L D AH NG
BILDO	B AY L D OW
BILDONG	B AY L D AO NG
BILI	B AY L IY
BILILHON	B AY L IH L HH AH N
BILIN	B AY L IH N
BILYARAN	B AY L IY AH R AE N
BILYON	B AY L IY AO N
BINABA	B AY N AE B AH
BINABAYE	B AY N AE B EY
BINALAYE	B AY N AE L EY
BINANDOL	B AY N AE N D AH L
BINATA	B AY N AE T AH
BINDITA	B AY N D IH T AH
BINGO	B IH NG G OW
BINHI	B AY N HH IY
BINHOD	B AY N HH AA D
BINIGNIT	B AY N IH G N AH T
BINIGYAN	B AY N IH JH AY AH N
BINILANGGO	B AY N AH L AE N G OW
BINISAY	B AY N IH S EY IY
BINIYAAN	B AY N AY AY EY AH N
BINTANA	B AY N T AE N AH
BINUANG	B AY N Y UW AH NG
BINUGAO	B AY N Y UW G EY OW
BINUHAT	B AY N AH HH AH T
BINUHATAN	B AY N AH EY T AH N
BINULA	B AY N Y UW L AH
BINUNALAN	B AY N Y UW N AH L AH N
BINUTBOT	B AY N AH T B AH T
BINUYOKAN	B AY N Y UW AY AH K AH N
BIOLOHIKAL	B AY AH L AA HH AH K AH L
BIPSTIKON	B AY S T IH K AH N
BIRHEN	B IH R AH N
BIRONDO	B AY R AA N D OW
BIRTH	B ER TH
BIRTHDAY	B ER TH D EY
BISAG	B AY S AE G
BISAGRA	B AY S AE G R AH
BISAN	B AY Z AH N
BISAYA	B AY S EY AH
BISBOL	B AY S B AA L
BISBOLAN	B AY S B OW L AH N
BISCOCHO	B AY S AA CH OW
BISDAK	B AY S D AE K
BISE	B AY Z
BISEKLITA	B AY S EH K L AH T AH
BISIG	B IH S IH G
BISIKLETA	B AY S IH K L AH T AH
BISITA	B AY S IH T AH
BISITAHAN	B AY S IH T AH AH N
BISKWIT	B AY S W IH T
BISTI	B AY S T IY
BISTIDA	B AY S T IH D AH
BISTO	B AY S T OW
BITAW	B AY T AO
BITE	B AY T
BITIIS	B AY T AY IY Z
BITIN	B AY T IH N
BITOK	B AY T AA K
BITUN	B AY T AH N
BITUON	B AY T Y UW AH N
BIYA	B AY Y AA
BIYAAN	B AY Y EY AH N
BIYAHE	B AY Y AE HH
BIYAHERO	B AY IY AH HH IY R OW
BIYATILIS	B AY IY AH T IY L IY Z
BIYAYA	B AY Y EY AH
BIYERNES	B AY Y AH R N Z
BIYOGRAPIYA	B AY Y AA G R AH P IY AY AH
BIYOLETA	B AY Y AA L AH T AH
BIYOLOGO	B AY Y AA L AH G OW
BIYUDA	B AY Y UW D AH
BIYUDO	B AY Y UW D OW
BLACKMAIL	B L AE K M EY L
BLADE	B L EY D
BLAME	B L EY M
BLANGKO	B L AE N G K OW
BLAWS	B L AO Z
BLIND	B L AY N D
BLLOD	B L AA D
BLOTTER	B L AA T ER
BLUSA	B L UW S AH
BO	B OW
BOANG	B OW NG
BOANGBOANG	B OW N G OW NG
BOARD	B AO R D
BOARDER	B AO R D ER
BOBONG	B AA B AH NG
BODEGA	B OW D EY G AH
BOGO	B OW G OW
BOHOL	B AA HH AH L
BOKSIDOR	B AA K S AH D AH R
BOKSING	B AA K S AH NG
BOKSINGERO	B AA K S IH N JH AH R OW
BOKSIYADOR	B AA K S IY AY AH D AH R
BOLA	B OW L AH
BOLING	B OW L IH NG
BOLSA	B OW L S AH
BOLUNTARYO	B AA L AH N T AE R AY OW
BOLUNTARYOHA	B AH L AH N T AH R AY AH HH AH
BOMBA	B AA M B AH
BOMBAHE	B AA M B AH HH
BOMBARDIYO	B AA M B AH R D IY AY OW
BOMBAY	B AA M B EY
BOMBERO	B AA M B AH R OW
BONETE	B AH N IY T
BONIFACIO	B AA N IH F EY S IY OW
BONNET	B AA N AH T
BONTONG	B AA N T AH NG
BONUS	B OW N AH S
BOOGER	B UW JH AH R
BOOM	B UW M
BOOT	B UW T
BORDER	B AO R D ER
BORJA	B AO R Y AH
BORROW	B AA R OW
BOSS	B AA S
BOSS(2)	B AO S
BOTANISTA	B AA T AH N IH S T AH
BOTAS	B AA T AH Z
BOTELYA	B AH T EH L AY AH
BOTHER	B AA DH ER
BOTIKA	B AA T AH K AH
BOTILYA	B AH T IH L AY AH
BOTOS	B OW T OW Z
BOUNDARY	B AW N D ER IY
BOUNDARY(2)	B AW N D R IY
BOXING	B AA K S IH NG
BOYAHAN	B OY AH AH N
BRA	B R AA
BRAD	B R AE D
BRAKE	B R EY K
BRANDI	B R AE N D IY
BRASA	B R AE S AH
BRASO	B R AE S OW
BRAVE	B R EY V
BRAWN	B R AO N
BRAWONKAPE	B R AO AH NG K EY P
BRAYT	B R EY T
BREAKFAST	B R EH K F AH S T
BRET	B R EH T
BRGY	B R JH AY
BRIBE	B R AY B
BRIGADA	B R IH G AH D AH
BRILYANTE	B R IH L AY AH N T
BRITIS	B R AY T AH S
BRITISH	B R IH T IH SH
BROKER	B R OW K ER
BRONGKITIS	B R AA N G K AY T AH S
BRONSE	B R AA N S
BROTHER	B R AH DH ER
BROWN	B R AW N
BRUCE	B R UW S
BRUSH	B R AH SH
BUAK	B Y UW AH K
BUANG	B Y UW AH NG
BUAYA	B Y UW EY AH
BUBHO	B AH B HH OW
BUBUKOL	B Y UW B Y UW K AH L
BUCANA	B Y UW K AH N AH
BUCK	B AH K
BUDBOD	B AH D AH D
BUDGET	B AH JH IH T
BUDHI	B AH D HH IY
BUDISMO	B Y UW D IH Z M OW
BUDISTA	B Y UW D IH S T AH
BUDYONG	B Y UW D AY AH NG
BUENAFE	B Y UW AH N EY F
BUENAVISTA	B Y UW AH N AH V IH S T AH
BUG	B AH G
BUGAN	B Y UW G AH N
BUGANA	B Y UW G AH N AH
BUGAS	B Y UW G AH Z
BUGASBUGAS	B Y UW G AH Z Y UW G AH Z
BUGAT	B Y UW G AH T
BUGAW	B Y UW G AH
BUGAY	B Y UW G EY
BUGDO	B AH G D UW
BUGKOS	B AH G K AH Z
BUGNAW	B AH G N AH
BUGNO	B AH G N OW
BUGO	B Y UW G OW
BUGOY	B Y UW G OW IY
BUGTI	B AH G T IY
BUGTONG	B AH G T AA NG
BUGWAL	B AH G W AH L
BUHAT	B AH HH AH T
BUHATA	B AH HH AH T AH
BUHATAN	B AH EY T AH N
BUHATASA	B AH HH AE T AH S AH
BUHATI	B AH HH AH T IY
BUHATON	B AH HH AH T AH N
BUHAWI	B AH HH AH IY
BUHAY	B AH HH EY IY
BUHI	B AH HH IY
BUHIAN	B AH IY AH N
BUHII	B AH HH IY
BUHILAMAN	B AH HH IH L AH M AH N
BUHIS	B AH AH S
BUHO	B AH HH OW
BUHOK	B AH HH AH K
BUILDING	B IH L D IH NG
BUKA	B Y UW K AH
BUKAD	B Y UW K AH D
BUKAG	B Y UW K AH G
BUKAL	B Y UW K AH L
BUKALAN	B Y UW K AH L AH N
BUKID	B Y UW K AH D
BUKO	B Y UW K OW
BUKOBUKO	B Y UW K AH B Y UW K OW
BUKOG	B Y UW K AH G
BUKOL	B Y UW K AH L
BUKON	B Y UW K AH N
BUKOT	B Y UW K AH T
BUKTON	B AH K T AH N
BULA	B Y UW L AH
BULAD	B Y UW L AH D
BULAG	B Y UW L AH G
BULAGAN	B Y UW L AH JH AH N
BULAGAW	B Y UW L AH G AH
BULAHAN	B Y UW L AH AH N
BULAK	B Y UW L AH K
BULAN	B Y UW L AH N
BULANG	B Y UW L AH NG
BULAWAN	B Y UW L AH AH N
BULAWANON	B Y UW L AO AH N AH N
BULBO	B UH L B OW
BULBOL	B UH L B AH L
BULETIN	B Y UW L AH T AH N
BULGAR	B AH L JH ER
BULIG	B Y UW L AH G
BULING	B Y UW L AH NG
BULINGON	B Y UW L IH N G AH N
BULLET	B UH L AH T
BULOK	B Y UW L AH K
BULONTARYONG	B Y UW L AH N T AE R AY AH NG
BULOS	B Y UW L AH Z
BULTO	B UH L T OW
BULTOHON	B UH L T AH HH AH N
BULUHATON	B Y UW L AH HH AH T AH N
BUMALIK	B Y UW M AH L AH K
BUMANGON	B Y UW M AE N G AH N
BUN	B AH N
BUNG	B AH NG
BUNGA	B AH N G AH
BUNGALOW	B AH NG G AH L OW
BUNGANG	B AH N G AE NG
BUNGDO	B AH N G D OW
BUNGI	B AH N JH IY
BUNGOT	B AH N G AA T
BUNGTOD	B AH N G T AH D
BUNGUTON	B AH N G AH T AO N
BUNOAY	B Y UW N OW IY
BUNOK	B Y UW N AH K
BUNOT	B Y UW N AH T
BUNTAG	B AH N T AE G
BUNTAGA	B AH N T AH G AH
BUNYAG	B Y UW N AY AH G
BUNYAGANAN	B Y UW N AY AE G AH N AH N
BUOK	B Y UW AH K
BUONGON	B Y UW AA N G AH N
BUOT	B Y UW AH T
BUOTAN	B Y UW OW T AH N
BUOTANG	B Y UW AH T AH NG
BURNABLE	B ER N AH B AH L
BUROKRASYA	B Y UH R AH K R AE S AY AH
BUROS	B Y UH R AH Z
BUROT	B Y UH R AH T
BURUS	B Y UH R AH S
BUS	B AH S
BUSA	B Y UW S AH
BUSANO	B Y UW S AH N OW
BUSAY	B Y UW S EY IY
BUSINESS	B IH Z N AH S
BUSINESS(2)	B IH Z N IH S
BUSINESSMAN	B IH Z N AH S M AE N
BUSINESSMAN(2)	B IH Z N IH S M AE N
BUSLOT	B AH S L AA T
BUSOG	B Y UW S AH G
BUSTO	B AH S T OW
BUSWAK	B AH S W AH K
BUSY	B IH Z IY
BUSYAD	B Y UW S AY AH D
BUTA	B Y UW T AH
BUTAKAL	B Y UW T AH K AH L
BUTANG	B Y UW T AH NG
BUTANGA	B Y UW T AE N G AH
BUTANGAN	B Y UW T AE N G AH N
BUTANGANAN	B Y UW T AE N G AH N AH N
BUTANGI	B Y UW T AE N JH IY
BUTANGIRO	B Y UW T AE N JH AH R OW
BUTBOTON	B AH T B AH T AH N
BUTBUT	B AH T B AH T
BUTCH	B UH CH
BUTO	B Y UW T OW
BUTOBUTO	B Y UW T AH B Y UW T OW
BUTONES	B Y UW T OW N Z
BUTONG	B Y UW T AH NG
BUTUAN	B Y UW T Y UW AH N
BUTYAG	B Y UW T AY AH G
BUUL	B Y UW AH L
BUULBUUL	B Y UW AH L B Y UW AH L
BUUTAN	B Y UW Y UW T AH N
BUWAD	B AH W AH D
BUWAG	B AH W AH G
BUWAK	B AH W AH K
BUWAN	B AH W AH N
BUWISIT	B AH W AH S AH T
BUYBOY	B AY B OY
BUYOG	B Y UW AY AH G
BUZZ	B AH Z
BWINGGIT	B W IH N JH AH T
BYERNES	B AY AH R N Z
BYSTANDER	B AY S T AE N D ER
C	S IY
CABANCALAN	K AH B AE NG K AH L AH N
CABIGAS	K AE B AH G AH Z
CABRERA	K AA B R EH R AH
CAFE	K AH F EY
CAFE(2)	K AE F EY
CAGAYAN	K AE G EY AH N
CAKE	K EY K
CALAJOAN	K AH L AE JH OW AH N
CALIDA	K AA L IY D AH
CALINAN	K AE L AH N AH N
CALLUS	K AE L AH S
CALSA	K AE L S AH
CAMAMAN	K AE M AH M AE N
CAMERA	K AE M ER AH
CAMERA(2)	K AE M R AH
CAMOTE	K AH M OW T
CAMPANER	K AE M P EY N ER
CAMPUS	K AE M P AH S
CANADIAN	K AH N EY D IY AH N
CANADYANO	K AE N AH D AY AH N OW
CANCER	K AE N S ER
CANTON	K AE N T AH N
CAP	K AE P
CAPA	K AE P AH
CARBINE	K AA R B AY N
CARBON	K AA R B AH N
CARDINAL	K AA R D IH N AH L
CARUNGAY	K AA R AH N G EY
CASH	K AE SH
CASHIER	K AE SH IH R
CASSETTES	K AH S EH T S
CAST	K AE S T
CASTELO	K AA S T EH L OW
CASTROOS	K AE S T R UW Z
CATALINO	K AH T AE L AH N OW
CATHETER	K AE TH AH T ER
CEBU	S IY B UW
CEBUANO	S EH B Y UW AH N OW
CELL	S EH L
CELLOPHANE	S EH L AH F EY N
CELLPHONE	S EH L F OW N
CELLULAR	S EH L Y AH L ER
CENTER	S EH N T ER
CENTER(2)	S EH N ER
CEO	S IY IY OW
CERES	S IH R IY Z
CESAR	S IY Z ER
CHAMPIONSHIP	CH AE M P IY AH N SH IH P
CHANNEL	CH AE N AH L
CHARGE	CH AA R JH
CHEF	SH EH F
CHES	CH EH S
CHIEF	CH IY F
CHIP	CH IH P
CHOCOLATE	CH AO K L AH T
CHONG	CH AO NG
CHOPSUEY	CH AA P S UW IY
CHORISO	CH AO R AH S OW
CHRISTINE	K R IH S T IY N
CIDG	S IH JH
CIRIACO	S IH R IY AA K OW
CITY	S IH T IY
CIUDAD	S IY UW D AE D
CLARK	K L AA R K
CLASS	K L AE S
CLINIC	K L IH N IH K
CLOSE	K L OW S
CLOSE(2)	K L OW Z
CLUB	K L AH B
COACH	K OW CH
COCIDO	K OW S IH D OW
CODE	K OW D
COGON	K AA G AO N
COLGATE	K OW L G EY T
COLLAPSE	K AH L AE P S
COLON	K OW L AH N
COME	K AH M
COMENDIDO	K AH M AH N D IH D OW
COMMUNITY	K AH M Y UW N AH T IY
COMMUNITY(2)	K AH M Y UW N IH T IY
COMPANY	K AH M P AH N IY
COMPOSTELA	K AA M P AA S T AH L AH
COMPUTER	K AH M P Y UW T ER
CON	K AA N
CONCOLES	K AH N K OW L Z
CONFERENCE	K AA N F ER AH N S
CONFERENCE(2)	K AA N F R AH N S
CONSOLACION	K AH N S AA L AH S IY AH N
CONSULTANT	K AH N S AH L T AH N T
COOKIE	K UH K IY
COR	K AO R
CORDOVA	K AO R D OW V AH
CORPORATE	K AO R P ER AH T
CORPORATE(2)	K AO R P R AH T
CORRO	K AA R OW
COTABATO	K OW T AE B AH T OW
COURT	K AO R T
CPPO	K P OW
CPU	K P UW
CREATED	K R IY EY T AH D
CREATED(2)	K R IY EY T IH D
CRIME	K R AY M
CRIMINAL	K R IH M AH N AH L
CRISPY	K R IH S P IY
CROSSING	K R AO S IH NG
CRUZ	K R UW Z
CURFEW	K ER F Y UW
CUSTOMER	K AH S T AH M ER
CUT	K AH T
CYBER	S AY B ER
CYCLE	S AY K AH L
DA	D AA
DA(2)	D IY EY
DAAN	D EY AH N
DAANHI	D AA N HH IY
DABAHAN	D AE B AH AH N
DACUA	D AE K Y UW AH
DAD	D AE D
DADI	D AE D IY
DAG	D AE G
DAGAN	D EY G AH N
DAGANON	D AE G AH N AH N
DAGAT	D AE G AH T
DAGHAN	D AE AH N
DAGHANG	D AE G HH AE NG
DAGINOT	D AE JH AH N AH T
DAGITAB	D AE JH AH T AH B
DAGKO	D AE G K OW
DAGKONG	D AE G K AH NG
DAGNAY	D AE G N EY IY
DAGOHOY	D AH G AA HH OW IY
DAGSA	D AE G S AH
DAGUM	D AE G AH M
DAGWAY	D AE G W EY
DAHIG	D AE HH AH G
DAHIL	D AE HH AH L
DAHOM	D AE HH AH M
DAHON	D AE HH AH N
DAHUNOG	D AE HH Y UW N AH G
DAIG	D EY G
DAITABNON	D EY T AE B N AH N
DAKBAYAN	D AE K B EY AH N
DAKDAKAN	D AE K D AH K AH N
DAKIT	D AE K AH T
DAKLIT	D AE K L AH T
DAKO	D AE K OW
DAKODAKO	D AH K AA D AH K OW
DAKONG	D AE K AH NG
DAKPA	D AE K AH
DAKPON	D AE K AH N
DAKU	D AE K UW
DAKUNG	D AE K AH NG
DAKUP	D AE K AH P
DAL	D AE L
DALA	D AE L AH
DALAD	D AE L AH D
DALAG	D AE L AH G
DALAGA	D AE L AH G AH
DALAN	D EY L AH N
DALANG	D AE L AH NG
DALAWANG	D AE L AH AH NG
DALAYEGON	D AH L EY AH G AH N
DALAYGONON	D AH L EY G AH N AH N
DALHA	D AE L HH AH
DALHON	D AE L HH AH N
DALI	D AA L IY
DALIA	D AA L Y AH
DALING	D EY L IH NG
DALO	D AA L OW
DALUGDOG	D AH L AH G D AH G
DALUNGGAN	D AH L AH N G AH N
DAM	D AE M
DAMA	D AA M AH
DAMAN	D EY M AH N
DAMGO	D AE M G OW
DAMLAG	D AE M L AE G
DAN	D AE N
DANAG	D AE N AH G
DANCE	D AE N S
DANGAT	D AE N G AH T
DANGATAN	D AE N G EY T AH N
DANGAW	D AE N G AH
DANGER	D EY N JH ER
DANGGIT	D AE N JH AH T
DANGHAG	D AE N AH G
DANGTAN	D AE N G T AH N
DANIEL	D AE N Y AH L
DANILO	D AE N AH L OW
DANYOS	D AE N AY AH Z
DAOG	D EY AH G
DAOGDAOG	D EY AA G D EY AH G
DAOT	D EY AH T
DAOTAN	D EY AH T AH N
DAPAT	D AE P AH T
DAPI	D AE P IY
DAPIT	D AE P AH T
DAPITA	D AE P AH T AH
DAPLIN	D AE P L AH N
DARLING	D AA R L IH NG
DASIG	D AE S AH G
DASMAGI	D AE Z M AH JH IY
DATA	D EY T AH
DATA(2)	D AE T AH
DATAHAN	D AE T AH AH N
DATO	D AA T OW
DATU	D AE T UW
DATUNAHON	D AE T Y UW N AH HH AH N
DAUB	D AO B
DAUG	D AO G
DAUT	D AO T
DAUTAN	D EY Y UW T AH N
DAVAO	D AH V OW
DAVAO(2)	D EY V OW
DAW	D AO
DAWAATA	D AO AH T AH
DAWATA	D AO AH T AH
DAWATON	D AO AH T AH N
DAWIN	D AO AH N
DAWO	D AO OW
DAYAG	D EY AH G
DAYALOGO	D EY AE L AH G OW
DAYANDAYAN	D EY AE N D EY AH N
DAYEG	D EY AH G
DAYON	D EY AO N
DAYONG	D EY AH NG
DAYUN	D EY AH N
DBM	D IY B IY M
DE	D IY
DE(2)	D EY
DE(3)	D AH
DEAD	D EH D
DEAL	D IY L
DEBATE	D AH B EY T
DEBOTO	D AH B OW T OW
DECIMAL	D EH S AH M AH L
DECK	D EH K
DECONGEST	D IY K AH N JH EH S T
DEGREE	D IH G R IY
DEKADA	D AH K AE D AH
DEKADANG	D AH K AE D AH NG
DEL	D EH L
DELA	D EH L AH
DELATA	D AH L AE T AH
DELEGATE	D EH L AH G EY T
DELEGATE(2)	D EH L AH G AH T
DELIBERAN	D AH L IH B AH R AH N
DELIKADO	D AH L IH K AH D OW
DELIO	D EY L IY OW
DEMOKRASYA	D AH M AA K R AE S AY AH
DEMOKRATIKO	D AH M AA K R AE T AH K OW
DEMOKRATIKONG	D AH M AA K R AE T AH K AH NG
DEMOLISYON	D IY M OW L IY Z IY AO N
DEPARTAMENTO	D AH P AA R T AH M EH N T OW
DEPARTMENT	D IH P AA R T M AH N T
DEPENSA	D AH P EH N S AH
DEPINISYON	D IY P AY N IY Z IY AO N
DEPOSITO	D AH P AA S AH T OW
DERETSO	D IH R AH T S OW
DESCRIPTION	D IH S K R IH P SH AH N
DESIREE	D EH S AY R IY
DESISYON	D AH S IH S AY AH N
DESPERADO	D EH S P ER AA D OW
DESTINASYON	D IH S T AH N AE S AY AH N
DESTINATION	D EH S T AH N EY SH AH N
DESTINATION(2)	D EH S T IH N EY SH AH N
DETALYADO	D IY T EY L IY AH D UW
DETALYE	D AH T AE L AY
DETECTION	D IH T EH K SH AH N
DETECTOR	D IH T EH K T ER
DETINADO	D IY T IH N AH D UW
DEVERA	D EY V EH R AH
DEVICE	D IH V AY S
DI	D IY
DI(2)	D AY
DIAAN	D AY AH AH N
DIAY	D AY AH IY
DIBORSYO	D AH B AO R S AY OW
DIBUYNAS	D IH B Y UW AH N AH Z
DIDTO	D IH D T OW
DIETO	D IY T OW
DIFFICULT	D IH F AH K AH L T
DIG	D IH G
DIGAL	D IH G AH L
DIGITAL	D IH JH AH T AH L
DIGITAL(2)	D IH JH IH T AH L
DIGMAAN	D IH G M EY AH N
DIGOS	D IH G AA S
DIGWA	D IH G W AH
DIHA	D IH HH AH
DIHADIHA	D AH HH AE D AH HH AH
DIHAG	D IH HH AH G
DIHAL	D IH AH L
DIHANG	D IH HH AH NG
DIHAY	D IH HH EY IY
DIIN	D IY N
DIING	D AY IH NG
DIKSIYONARYO	D IH K S IY AY AH N AE R AY OW
DIKSYONARYO	D IH K S AY AH N AE R AY OW
DILA	D IH L AH
DILI	D IH L IY
DILIGENT	D IH L IH JH AH N T
DILIKADO	D AH L IH K AH D OW
DILIPA	D IH L AH P AH
DILIRYO	D AH L IH R AY OW
DIMALAS	D IH M AH L AH Z
DIN	D IH N
DINAHUNAN	D IH N AH HH Y UW N AH N
DINALAYEG	D AH N AE L EY AH G
DINALIANG	D AH N EY L IY AH NG
DINAPIT	D IH N AH P IH T
DINGDING	D IH N G D AH NG
DINHA	D IH N HH AH
DINHAY	D IH N HH EY
DINHI	D IH N HH IY
DINILIG	D IH N AH L AH G
DINUGOAN	D IH N Y UW G OW AH N
DINUGUAN	D IH N Y UW G Y UW AH N
DIOS	D IY OW S
DIOSDADO	D AY AA Z D AH D OW
DIPERENSIYA	D IH P AH R AH N S IY AY AH
DIPLOMAT	D IH P L AH M AE T
DIPOLOG	D IH P AH L AH G
DIRECTOR	D ER EH K T ER
DIRECTOR(2)	D AY R EH K T ER
DIRECTOR(3)	D IY R EH K T ER
DIRECTOR(4)	D IH R EH K T ER
DIREKSYON	D AH R EH K S AY AH N
DIREKTA	D AH R EH K T AH
DIREKTOR	D AH R EH K T AH R
DIRETSO	D AH R EH T S OW
DIRETSOHA	D AH R EH T S AH HH AH
DIRI	D IH R IY
DIRITSO	D AH R IH T S OW
DIRIYOT	D AH R IY AY AH T
DISENYO	D IH S AH N Y OW
DISGRASYA	D IH S G R AE S AY AH
DISIPLINA	D AH S IH P L AH N AH
DISKRIMINASYON	D IH S R IH M AH N AE S AY AH N
DISKUSYON	D IH S K Y UW S IY AO N
DISKWENTO	D IH S W EH N T OW
DISPLAY	D IH S P L EY
DISTANSIYA	D IH S T AE N S IY AY AH
DISTANSYA	D IH S T AE N S AY AH
DISTRICT	D IH S T R IH K T
DISTRITO	D IH S T R IH T OW
DISYEMBRE	D IH S Y EH M B AH R
DISYERTO	D IH S Y AH R T OW
DITO	D IH T OW
DIVISION	D IH V IH ZH AH N
DIVISORIA	D IH V AH S AO R IY AH
DIYAK	D AY AY AH K
DIYES	D AY AY Z
DIYOS	D AY IY AA S
DIYOTAY	D AY AY AA T EY IY
DIYUTAY	D AY AY UW T EY IY
DIYUTAYNG	D AY AY AH T EY NG
DNA	D IY EH N EY
DOBLE	D OW B AH L
DOBLENG	D AA B L AH NG
DODAGTUM	D AH D AE G T AH M
DODONG	D AA D AH NG
DOK	D AA K
DOKTOR	D AA K T ER
DOKTORA	D AA K T AH R AH
DOKUMENTO	D AA K Y AH M EH N T OW
DOLYAR	D UW L IY ER
DOMESTIC	D AH M EH S T IH K
DOMINANTE	D AA M AH N AH N T
DOMINGGO	D OW M IH NG G OW
DOMINGO	D OW M IH NG G OW
DOMINGO(2)	D AH M IH NG G OW
DONG	D AO NG
DONG(2)	D AO NG G
DONNA	D AA N AH
DORMAT	D AO R M AH T
DOS	D AO S
DOS(2)	D OW S
DOSDOS	D UW Z D UW Z
DOSE	D OW S
DOSENA	D AA S AH N AH
DOSIENTOS	D OW S IY AH N T AA S
DOWNTOWN	D AW N T AW N
DRAFT	D R AE F T
DRAG	D R AE G
DRAMA	D R AA M AH
DRAMATIKONG	D R AH M AE T AH K AH NG
DRAYBER	D R EY B AH R
DREAM	D R IY M
DRIVER	D R AY V ER
DROGA	D R AA G AH
DROWING	D R OW AH NG
DROWINGA	D R OW IH N G AH
DRUG	D R AH G
DRUGS	D R AH G Z
DT	D IY T
DU	D UW
DU(2)	D AH
DUBOK	D Y UW B AH K
DUDUKUTIN	D Y UW D Y UW K Y UW T AH N
DUG	D AH G
DUGA	D Y UW G AH
DUGANG	D Y UW G AH NG
DUGANGAN	D Y UW G AE N G AH N
DUGANGI	D Y UW G AE N JH IY
DUGAY	D Y UW G EY IY
DUGHAN	D AH AH N
DUGHO	D AH OW
DUGO	D UW G OW
DUGOAN	D Y UW G OW AH N
DUGOKON	D Y UW G AH K AH N
DUGOON	D Y UW G UW N
DUGOS	D AH G AA S
DUGTONG	D AH G T AA NG
DUGUKAN	D Y UW G Y UW K AH N
DUHA	D AH HH AH
DUHADUHA	D AH HH AE D AH HH AH
DUHAY	D AH HH EY IY
DUKA	D Y UW K AH
DUKOMENTO	D Y UW K AH M EH N T OW
DUKOT	D Y UW K AH T
DUL	D AH L
DULA	D UW L AH
DULCE	D AH L S
DUMAGUETE	D Y UW M AH G W IY T
DUMALA	D Y UW M AH L AH
DUMAPO	D Y UW M AH P OW
DUMDUM	D AH M D AH M
DUMILI	D Y UW M AH L IY
DUMOG	D Y UW M AH G
DUMOT	D Y UW M AH T
DUMUDOONG	D Y UW M Y AH D UW NG
DUMUT	D Y UW M AH T
DUNA	D UW N AH
DUNAY	D AH N EY
DUNGAN	D AH NG G AH N
DUNGGAN	D AH N G AH N
DUNGGANON	D AH N G AH N AH N
DUNGGOANAN	D AH N G OW N AH N
DUNGOG	D AH N G AH G
DUOK	D Y UW AH K
DUOL	D Y UW AH L
DUOLAN	D Y UW OW L AH N
DUOLON	D Y UW AH L AH N
DUON	D Y UW AH N
DUPA	D Y UW P AH
DUPANG	D Y UW P AH NG
DURIAN	D Y UH R IY AH N
DUTERTE	D Y UW T AH R T
DUTY	D UW T IY
DUTY(2)	D Y UW T IY
DUUL	D Y UW AH L
DUWA	D AH W AH
DUWAG	D AH W AH G
DWENDE	D W EH N D
DYAKET	D AY AH K AH T
DYAMANTE	D AY AH M AH N T
DYIP	D AY AH P
DYSS	D IH S
DYUTAY	D AY UW T EY IY
E	IY
EBEDENSIYA	EH B AH D AH N S IY AY AH
EBIDENSYA	EH B AH D EH N S AY AH
EBOLUSYON	EH B AH L UW S AY AH N
EDAD	EH D AH D
EDDIE	EH D IY
EDIPISYO	EH D AH P IH S AY OW
EDISYON	AH D IH S AY AH N
EDITOR	EH D AH T ER
EDITOR(2)	EH D IH T ER
EDUARDO	EH D W AA R D OW
EDUKADO	EH D Y UW K AH D OW
EDUKAR	EH D Y UW K AH R
EDUKASYON	EH D Y AH K AE S AY AH N
EHE	EH HH
EHEKUTIBO	EH HH AH K Y UW T AH B OW
EHERSISYO	EH HH AH R S IH S AY OW
EIGHT	EY T
EIGHTEEN	EY T IY N
EIGHTY	EY T IY
EKONOMIKANHON	AH K AA N AH M AH K AE N HH AH N
EKONOMISTA	EH K AH N AH M IH S T AH
EKONOMIYA	EH K AH N AH M IY AY AH
EKSAKTO	EH K S AE K T OW
EKSAMEN	EH K S AH M AH N
EKSIBIT	EH K S AH B AH T
EKSPERIMENTO	EH K S AH R AH M EH N T OW
EKSPERTO	EH K S AH R T OW
EKSPOS	EH K S AH Z
EKSPRESYON	EH K S R EH S AY AH N
EKSTRA	EH K S T R AH
EL	EH L
ELEBETOR	AH L EH B AH T AH R
ELEKSYON	AH L EH K S AY AH N
ELEKTRISIDAD	EH L AH K T R IH S AH D AH D
ELEKTRONIKO	EH L AH K T R AA N AH K OW
ELEMENTARY	EH L AH M EH N T R IY
ELEMENTARY(2)	EH L AH M EH N T ER R IY
ELEMENTARY(3)	EH L AH M EH N CH R IY
ELEMENTARYA	EH L AH M AH N T AE R AY AH
ELEMENTO	EH L AH M EH N T OW
ELEVEN	IH L EH V AH N
ELEVEN(2)	IY L EH V AH N
ELINO	EH L AH N OW
ELITE	IH L IY T
ELITE(2)	EY L IY T
ELIZABETH	IH L IH Z AH B AH TH
ELIZABETH(2)	IH L IH Z AH B IH TH
ELLEN	EH L AH N
EMBAHADA	IH M B AE HH AH D AH
EMBOLODI	IH M B AA L AH D IY
EMBUTIDO	IH M B Y UW T AH D OW
EMERGENCY	IH M ER JH AH N S IY
EMERGENCY(2)	IY M ER JH AH N S IY
EMOSYON	IH M AA S IY AO N
EMOSYONAL	IH M AA S IY AO N AH L
EMPLEYADO	IH M P L EY AH D OW
ENBELOP	EH N B IH L AA P
ENERO	AH N EH R OW
ENFORCEMENT	EH N F AO R S M AH N T
ENGINEER	EH N JH AH N IH R
ENGINEERING	EH N JH AH N IH R IH NG
ENGKWENTRO	IH N G K W EH N T R OW
ENGLISH	IH NG G L IH SH
ENGLISH(2)	IH NG L IH SH
ENHINYERO	IH N HH AH N AY AH R OW
ENLARGE	EH N L AA R JH
ENSEMADA	IH N S EH M AH D AH
ENTIDAD	IH N T IH D AH D
ENTRADA	IH N T R AE D AH
ENTRY	EH N T R IY
EPEFANIO	EH P AH F EY N IY OW
EPEKTIBO	AH P EH K T AH B OW
EPEKTO	AH P EH K T OW
EPISODE	EH P IH S OW D
EPISYENTE	AH P IH S AY AH N T
ERIC	EH R IH K
ERNA	ER N AH
EROPLANO	AH R AA P L AH N OW
ERSON	AH R S AH N
ESCALATOR	EH S K AH L EY T ER
ESCLAMADO	EH S L AE M AH D OW
ESDRELON	EH Z D R AH L AH N
ESENSYA	AH S EH N S AY AH
ESKAPO	EH S AH P OW
ESKINA	EH S AH N AH
ESKORT	EH S AH R T
ESKRIBIYENTE	EH S R AH B IY AY AH N T
ESKUDO	EH S Y UW D OW
ESKUWELAHAN	EH S AH W EH L AH AH N
ESKWELAHAN	EH S W EH L AH AH N
ESPANYA	EH S AE N AY AH
ESPESYALISTA	EH S EH S AY AH L IH S T AH
ESPIHO	EH S AH HH OW
ESPINIDO	EH S IH N AH D OW
ESPIONAGE	EH S P IY AH N AA JH
ESPIRITU	EH S P IH R IY CH UW
ESPIYA	EH S IY AY AH
ESPLIN	EH S P L IH N
ESPORT	EH S AH R T
ESSAY	EH S EY
ESTASYONAN	EH S T AH S AY AH N AH N
ESTILO	EH S T AH L OW
ESTORYA	EH S T AO R AY AH
ESTORYAHAY	EH S T AH R AY AE HH EY IY
ESTRIKTA	EH S T R IH K T AH
ESTRIKTO	EH S T R IH K T OW
ESTUDYANTE	EH S T Y UW D AY AH N T
ESWELAHAN	EH S W EH L AH AH N
ETIQUETTE	EH T AH K AH T
ETNIKO	EH T N AH K OW
EUROPEAN	Y UH R AH P IY AH N
EVIDENCE	EH V AH D AH N S
EXAMINE	IH G Z AE M IH N
EXAMPLE	IH G Z AE M P AH L
EXCLUSIVE	IH K S K L UW S IH V
EXECUTIVE	IH G Z EH K Y AH T IH V
EXPENDITURE	IH K S P EH N D AH CH ER
EXPENDITURE(2)	IH K S P EH N D IH CH ER
EXPENSIVE	IH K S P EH N S IH V
EXPERIENCE	IH K S P IH R IY AH N S
EXPIRE	IH K S P AY R
EXPLOSIVE	IH K S P L OW S IH V
EXTENSION	IH K S T EH N SH AH N
EXTRAVAGANT	EH K S T R AE V AH G AH N T
FAMILY	F AE M AH L IY
FAMILY(2)	F AE M L IY
FAN	F AE N
FE	F EY
FEDERAL	F EH D ER AH L
FEDERAL(2)	F EH D R AH L
FELTON	F EH L T AH N
FERDINAND	F ER D IH N AE N D
FERDINAND(2)	F ER D IH N AE N
FERNANDEZ	F ER N AE N D EH Z
FERNANDEZ(2)	F EH R N AE N D EH Z
FERNANDEZ(3)	F ER N AA N D EH Z
FERNANDEZ(4)	F EH R N AA N D EH Z
FIFTEEN	F IH F T IY N
FIFTY	F IH F T IY
FILE	F AY L
FILIPINO	F IH L AH P IY N OW
FIRE	F AY ER
FIRE(2)	F AY R
FIRM	F ER M
FISH	F IH SH
FIVE	F AY V
FLAN	F L AE N
FLASHFLOODS	F L AE SH F L AH D Z
FLOOR	F L AO R
FLORA	F L AO R AH
FLORAGIPAKAON	F L AO R AH JH AH P AE K EY AH N
FOCUS	F OW K AH S
FOCUS(2)	F OW K IH S
FOOTBALL	F UH T B AO L
FOR	F AO R
FOR(2)	F ER
FOR(3)	F R ER
FORTUNA	F AO R T UW N AH
FORTY	F AO R T IY
FOUR	F AO R
FOURTEEN	F AO R T IY N
FRANC	F R AE NG K
FRANCES	F R AE N S IH S
FRANCISCO	F R AE N S IH S K OW
FREEZE	F R IY Z
FREQUENCY	F R IY K W AH N S IY
FUENTE	F W EH N T EY
FUNCTION	F AH NG K SH AH N
G	JH IY
GAAN	G EY AH N
GAANO	G AA N OW
GABA	G AA B AH
GABHIONA	G AE B HH IY AH N AH
GABHIUNA	G AE B HH IY UW N AH
GABI	G AE B IY
GABII	G EY B IY
GABINETE	G AE B AH N IY T
GAGMAYNG	G AE G M EY NG
GAHAPON	G AE HH AH P AH N
GAHI	G AE HH IY
GAHIGDA	G AH HH IH G D AH
GAKAHADLOK	G AE K AH HH AE D L AH K
GAKOS	G AE K AH Z
GALAB	G AE L AH B
GALAMITON	G AE L EY M IY T AH N
GALAXY	G AE L AH K S IY
GALAY	G AE L AH IY
GALINGON	G EY L IH NG AO N
GALLERY	G AE L ER IY
GAMAY	G AE M EY IY
GAMAYNG	G AH M EY NG
GAMBALAY	G AE M B AE L EY IY
GAMHANAN	G AE M HH AH N AH N
GAMIT	G AE M AH T
GAMITAN	G AE M AH T AH N
GAMITON	G EY M IY T AH N
GAMOT	G AE M AH T
GAMUT	G AE M AH T
GANA	G AE N AH
GANADO	G AE N AH D OW
GANAHAN	G AE N AH AH N
GANAHON	G AE N AH HH AH N
GANANCIA	G AH N AE N CH IY AH
GANANG	G AE N AH NG
GANG	G AE NG
GANGHAAN	G AE N EY AH N
GANI	G AE N IY
GANID	G AE N AH D
GANIG	G AE N AH G
GANIHA	G AE N AH HH AH
GANINA	G AE N AH N AH
GANING	G EY N AH NG
GANSA	G AE N S AH
GANSANG	G AE N S AH NG
GANSILYO	G AE N S IH L AY OW
GANTANG	G AE N T AH NG
GANTI	G AE N T IY
GAPAS	G AE P AH Z
GAPNUD	G AE P N AH D
GARA	G AE R AH
GARAHE	G AE R AH HH
GARANTIYA	G AE R AH N T IY AY AH
GARAON	G AE R EY AH N
GARBAGE	G AA R B IH JH
GARBANSOS	G AA R B AE N S AH Z
GARBOSO	G AA R B AH S OW
GARCIA	G AA R S IY AH
GARDEN	G AA R D AH N
GAS	G AE S
GASA	G AE S AH
GASABA	G AE S AH B AH
GASOLINA	G AH S AA L AH N AH
GASOLINAN	G AH S AA L AH N AH N
GASOLINE	G AE S AH L IY N
GASTADOR	G AE S T AH D AH R
GASTO	G AE S T OW
GASTOHAN	G AE S T AH AH N
GASTOHON	G AE S T AH HH AH N
GASTOON	G AE S T UW N
GASUL	G AE S AH L
GATAS	G AE T AH Z
GATASAN	G AE T AH Z AH N
GATOS	G AA T OW S
GATOS(2)	G AE T OW S
GATOS(3)	G EY T OW S
GATUON	G AE T Y UW AH N
GATUS	G EY T AH S
GATUSAN	G EY T AH S AH N
GAVINO	G AE V AH N OW
GAW	G AO
GAWA	G AO AH
GAWAIN	G AA W AH N
GAWAS	G AO AH Z
GAWASAN	G AO AH Z AH N
GAWASON	G AO AH S AH N
GAYAS	G EY AH Z
GAYOD	G EY AH D
GAYON	G EY AO N
GAYOY	G EY OW IY
GAYUD	G EY AH D
GEMS	JH EH M Z
GENE	JH IY N
GENERAL	JH EH N ER AH L
GENERAL(2)	JH EH N R AH L
GENEROUS	JH EH N ER AH S
GENETIC	JH AH N EH T IH K
GEOFFREY	JH EH F R IY
GERILYA	JH AH R IH L AY AH
GHOST	G OW S T
GI	JH IY
GIAGHAT	JH AY AH AH T
GIAGIAN	JH AY AH JH AH N
GIANDAM	JH AY AE N D AH M
GIANGKON	JH AY AE N G K AH N
GIANHA	JH AY AE N HH AH
GIANOD	JH AY AH N AH D
GIANTAWAN	JH AY AH N T AH W AA N
GIAPILAN	JH AY AE P AH L AH N
GIATANGAN	JH AY AH T AE N G AH N
GIATAY	JH AY AE T EY IY
GIATIMAN	JH AY AE T AH M AH N
GIATUBANG	JH AY AH T Y UW B AH NG
GIBABAD	JH IH B AH B AH D
GIBABAG	JH IH B AH B AH G
GIBABAGAN	JH AH B AE B AH JH AH N
GIBADBAD	JH AH B AE D AH D
GIBADLONG	JH AH B AE D L AH NG
GIBAHIN	JH IH B AH HH AH N
GIBAKWITAN	JH AH B AE K W AH T AH N
GIBALIGYA	JH IH B AH L IH JH AY AH
GIBALIK	JH IH B AH L AH K
GIBALITA	JH AH B AE L AH T AH
GIBANA	JH IH B AH N AH
GIBANABANA	JH IH B AH N AE B AH N AH
GIBANG	JH IH B AH NG
GIBANSAY	JH AH B AE N S EY IY
GIBANTAYAN	JH AH B AE N T EY AH N
GIBASA	JH IH B AH S AH
GIBASULAN	JH AH B AE ZH AH L AH N
GIBATI	JH IH B AH T IY
GIBATING	JH AY B EY T IH NG
GIBAYAD	JH IH B EY AH D
GIBAYARAN	JH AH B EY AH R AH N
GIBAYRAN	JH AH B EY R AH N
GIBILIN	JH IH B AH L AH N
GIBISITA	JH AH B IH S AH T AH
GIBITBIT	JH AH B IH T B AH T
GIBITUONAN	JH AH B IH T Y UW AH N AH N
GIBIYAAN	JH AH B IY AY EY AH N
GIBO	JH IH B OW
GIBOMBAHAN	JH AH B AA M B AH AH N
GIBUG	JH IH B AH G
GIBUGKOS	JH AH B AH G K AH Z
GIBUGKUSAN	JH AH B AH G K AH S AH N
GIBUHAT	JH IH B AH HH AH T
GIBULAD	JH IH B Y UW L AH D
GIBULAGAN	JH IH B Y UH L AH JH AH N
GIBUNALAN	JH IH B Y UW N AH L AH N
GIBUNLOT	JH AH B AH N L AH T
GIBUSA	JH IH B Y UW S AH
GIBUTANG	JH IH B Y UW T AH NG
GIBUTANGAN	JH IH B Y AH T AE N G AH N
GIBUTYAG	JH IH B Y UW T AY AH G
GIDAGIT	JH IH D AH JH AH T
GIDAK	JH IH D AH K
GIDALA	JH IH D AH L AH
GIDALI	JH IH D AH L IY
GIDAPIT	JH IH D AH P AH T
GIDASONAN	JH AH D AE S AH N AH N
GIDEKLARAR	JH AH D EH K L AH R AH R
GIDETALYE	JH AH D EH T AH L AY
GIDIKLARAR	JH AH D IH K L AH R AH R
GIDILI	JH IH D AH L IY
GIDUDAHAN	JH IH D Y UW D AH AH N
GIDUKA	JH IH D Y UW K AH
GIDUNGOG	JH AH D AH N G AH G
GIDUOL	JH IH D Y UW AH L
GIDUOLAN	JH IH D Y UW AH L AH N
GIDUSLAK	JH AH D AH Z L AH K
GIDUSO	JH IH D Y UW S OW
GIENTRAHAN	JH IY N T R AH AH N
GIFTED	G IH F T AH D
GIFTED(2)	G IH F T IH D
GIGAMIT	G IH G AH M IH T
GIGAPOS	JH IH G AH P AH Z
GIGIKANAN	JH AH JH IH K AH N AH N
GIGIPONG	JH IH JH AH P AH NG
GIGISA	JH IH JH AH S AH
GIGRUPO	JH IH G R UW P OW
GIGULGOL	JH AH G AH L G AH L
GIGUTOM	JH IH G Y UW T AH M
GIHABWA	JH AH HH AE B W AH
GIHADLOK	JH AH HH AE D L AH K
GIHANDOM	JH IH HH AH N
GIHANGGAT	JH AH HH AE N G AH T
GIHANGYO	JH AH HH AE N JH AY OW
GIHAPON	JH IH HH AH P AH N
GIHAPOS	JH IH HH AH P AH Z
GIHAPOY	JH AH HH AE P OW IY
GIHATAG	JH IH HH AH T AH G
GIHATAGAN	JH IH AH T AH JH AH N
GIHAYLO	JH AH HH EY L OW
GIHIGDAAN	JH AH HH IH G D EY AH N
GIHIGOT	JH IH HH AH G AH T
GIHIGUGMA	JH IH HH AH G AH G M AH
GIHIKAP	JH IH HH AH K AH P
GIHIKAY	JH AH HH IH K EY IY
GIHIKTAN	JH AH HH IH K T AH N
GIHIKYAD	JH AH HH IH K AY AH D
GIHILANTAN	JH IH HH AH L AE N T AH N
GIHIMO	JH IH HH AH M OW
GIHIMONG	JH IH HH AH M AH NG
GIHINABI	JH AH HH IH N AH B IY
GIHINAY	JH AH HH IH N EY IY
GIHINGANLAN	JH AH HH IH N G AE N L AH N
GIHINUKTOKAN	JH IH HH AH N AH K T AH K AH N
GIHIPA	JH IH HH AH P AH
GIHISGOTAN	JH AH HH IH Z AH T AH N
GIHOLD	JH AH HH OW L D
GIHUBAD	JH IH HH Y UW B AH D
GIHUBAGAN	JH IH HH Y UW B AH JH AH N
GIHUGTAN	JH AH HH AH G T AH N
GIHULAGWAY	JH IH HH Y AH L AE G W EY IY
GIHUMOL	JH IH HH Y UW M AH L
GIHUPTAN	JH AH HH AH P T AH N
GIHURNO	JH AH HH AH R N OW
GIHUWAT	JH IH HH AH W AH T
GIIBOT	JH IY B AH T
GIIGO	JH IY G OW
GIIHAW	JH IY HH AH
GIILA	JH IY L AH
GIILANG	JH IY L AH NG
GIIMBESTIGAHAN	JH IY M B EH S T IH G AH AH N
GIIMBESTIGAR	JH IY M B EH S T AH G AH R
GIIMNAN	JH IY M N AH N
GIINGNAN	JH IY N G N AH N
GIINGON	JH IY N G AH N
GIINGONG	JH IY N G AH NG
GIINTERBYU	JH IY N T AH R B AY UW
GIISIP	JH IY S AH P
GIISTORYAHAN	JH IY S T AH R AY AH AH N
GIKABIBUHAN	JH IH K AH B IH B AH AH N
GIKABUANGAN	JH AH K AE B Y UW AE N G AH N
GIKABUHI	JH AH K AE B AH HH IY
GIKAESTORYA	JH IH K IY S T AO R AY AH
GIKAHILIGAN	JH IH K AH HH IH L AH G AH N
GIKAHINABI	JH IH K AH HH IH N AH B IY
GIKAINTAPAN	JH AH K EY N T AH P AH N
GIKAISTORYA	JH IH K EY S T AO R AY AH
GIKAKITA	JH AH K AE K AH T AH
GIKALIPAY	JH IH K AH L IH P EY IY
GIKAMATYAN	JH IH K AH M AE T AY AH N
GIKAN	JH AY K AH N
GIKAPOY	JH AH K AE P OW IY
GIKASILAGAN	JH IH K AH Z IH L AH JH AH N
GIKASUBO	JH IH K AH S UW B OW
GIKATABANG	JH AH K AE T AH B AH NG
GIKATAHAPAN	JH IH K AH T AE HH AH P AH N
GIKATAHO	JH AH K AE T AH HH OW
GIKAUBAN	JH IH K AH B AH N
GIKAWAT	JH IH K AH AH T
GIKINAHANGLAN	JH AH K IH N AH HH AE N G L AH N
GIKOLEKTA	JH IH K AH L EH K T AH
GIKOMOT	JH IH K AH M AH T
GIKONDENAR	JH AH K AA N D AH N AH R
GIKONSULTA	JH IH K AH N S AH L T AH
GIKORAL	JH IH K AH R AH L
GIKUHA	JH IH K AH HH AH
GIKULATA	JH IH K Y UW L AH T AH
GIKULBAAN	JH AH K AH L B EY AH N
GIKUMOT	JH IH K Y UW M AH T
GIKUSGON	JH AH K AH Z AH N
GIKUTASAN	JH IH K Y UW T AH Z AH N
GIKUTLO	JH AH K AH T L OW
GIKUTO	JH IH K Y UW T OW
GIKUYAWAN	JH IH K Y UW AY AH AH N
GIKWARENTAYN	JH IH K W AE R AH N T EY N
GILA	G IY L AH
GILAAY	JH IH L AH IY
GILABAY	JH AH L AE B EY IY
GILABNI	JH AH L AE B N IY
GILADMON	JH AH L AE D M AH N
GILAKON	JH IH L AH K AH N
GILAMBOD	JH AH L AE M B AH D
GILAMBOS	JH AH L AE M B AH Z
GILAMISA	JH AH L AE M AH S AH
GILANGKOBAN	JH AH L AE N G K AH B AH N
GILANTAW	JH AH L AE N T AH
GILARAY	JH AH L AE R EY IY
GILAWA	JH IH L AH AH
GILAY	JH IH L EY IY
GILAYOG	JH IH L EY AH G
GILAYON	JH IH L EY AH N
GILAYONG	JH IH L EY AH NG
GILIBOTAN	JH AH L IH B AH T AH N
GILISDAN	JH AH L IH Z D AH N
GILIYOK	JH AH L IY AY AH K
GILLAMAC	JH IH L AH M AH K
GILUAGAN	JH AH L UW W AH JH AH N
GILUBA	JH AH L UW B AH
GILUKAT	JH AH L UW K AH T
GILUMOT	JH AH L UW M AH T
GILUNGKAB	JH AH L AH N G K AH B
GILUT	JH IH L AH T
GILUTO	JH AH L UW T OW
GILUWATAN	JH IH L AH W EY T AH N
GIMANDO	JH AH M AE N D OW
GIMANEHO	JH AH M AE N AH HH OW
GIMANEHONG	JH AH M AE N AH HH AH NG
GIMATNGONAN	JH AH M AE T N G AH N AH N
GIMINGAW	JH AH M IH N G AH
GINAKOT	JH IH N AH K AH T
GINAMOS	JH IH N AH M AH Z
GINAMUS	JH IH N AH M AH S
GINANSIYA	JH IH N AH N S IY AY AH
GINGANLAG	JH IH N G AE N L AH G
GINGANLAN	JH IH N G AE N L AH N
GINHAWA	JH IH N HH AH AH
GINIKANAN	JH AH N IH K AH N AH N
GINISAL	JH IH N IY Z AH L
GINOO	JH IH N UW
GINTO	JH IH N T OW
GINUKDANAY	JH AH N AH K D AE N EY IY
GIORDER	JH AY AO R D AH R
GIPAABOT	JH IH P AH B AH T
GIPAAWAT	JH IH P AH W AH T
GIPABAKWIT	JH IH P AH B AE K W AH T
GIPABALIK	JH AH P AE B AH L AH K
GIPABUKALAN	JH IH P AH B Y UW K AH L AH N
GIPABUTO	JH IH P AH B Y UW T OW
GIPADALI	JH AH P AE D AH L IY
GIPADAYAG	JH AH P AE D EY AH G
GIPAESKWELA	JH AH P IY S W AH L AH
GIPAHIABAWO	JH IH P AH HH IY AE B AH OW
GIPAHIBALO	JH IH P AH HH IH B AH L OW
GIPAHIBAWO	JH IH P AH HH IH B AH OW
GIPAHIGAYON	JH IH P AH HH IH G EY AH N
GIPAHILUNA	JH IH P AH HH AH L UW N AH
GIPAHINUMDOMAN	JH IH P AH HH AH N AH M D AH M AH N
GIPAHUNONG	JH IH P AH HH Y UW N AH NG
GIPAILA	JH AH P EY L AH
GIPAILIS	JH AH P EY AH L AH S
GIPAISA	JH AH P EY S AH
GIPAKANAOG	JH IH P AH K AE N EY AH G
GIPAKAON	JH AH P AE K EY AH N
GIPAKATAP	JH AH P AE K AH T AH P
GIPAKITA	JH AH P AE K AH T AH
GIPALAMAN	JH AH P AE L AH M AH N
GIPALIT	JH IH P AH L AH T
GIPALITAN	JH AH P AE L AH T AH N
GIPAMATUD	JH AH P AE M AH T AH D
GIPANAG	JH IH P AH N AH G
GIPANGAB	JH AH P AE N G AH B
GIPANGANDAMAN	JH IH P AH N G AE N D AH M AH N
GIPANGANDOY	JH IH P AH N G AE N D OW IY
GIPANGAYO	JH AH P AE N G EY OW
GIPANGDALA	JH AH P AE N G D AH L AH
GIPANGHASI	JH AH P AE N AH S IY
GIPANGHATAG	JH AH P AE N AH T AH G
GIPANGITA	JH AH P AE N JH AH T AH
GIPANGLISTA	JH IH P AH N G L IH S T AH
GIPANGULITAWHAN	JH AH P AE N G Y AH L IH T AH AH N
GIPANGULOHAN	JH IH P AH N G Y UW L AH AH N
GIPANGUTANA	JH IH P AH N G Y UW T AH N AH
GIPANIHAPON	JH IH P AH N IH HH AH P AH N
GIPANINGKAMOTAN	JH IH P AH N IH N G K AE M AH T AH N
GIPANINGOT	JH IH P AH N IH N G AH T
GIPANUMPA	JH IH P AH N AH M P AH
GIPAOTENTEKEYT	JH AH P EY AH T EH N T AH K EY T
GIPAPAULI	JH AH P AE P AH L IY
GIPARA	JH IH P AH R AH
GIPARTIHAN	JH AH P AA R T AH AH N
GIPASABOT	JH AH P AE S AH B AH T
GIPASABUT	JH AH P AE S AH B AH T
GIPASAGDAN	JH IH P AH S AE G D AH N
GIPASAHAN	JH AH P AE S AH AH N
GIPASAKAY	JH IH P AH S AE K EY IY
GIPASANGINLAN	JH IH P AH S AE N JH IH N L AH N
GIPASAYO	JH AH P AE S EY OW
GIPASIBYA	JH IH P AH S IH B AY AH
GIPASIDAN	JH AH P AE S AH D AH N
GIPASIUGDAHAN	JH AH P EY S IY AH G D AH AH N
GIPASOK	JH IH P AH S AH K
GIPASPASAN	JH AH P AE S AH Z AH N
GIPATAAS	JH IH P AH T AH Z
GIPATAM	JH IH P AH T AH M
GIPATAWAG	JH AH P AE T AH AH G
GIPATAY	JH AH P AE T EY IY
GIPATONG	JH IH P AH T AH NG
GIPAUBOS	JH IH P AH B AH Z
GIPAUTANG	JH IH P AH T AH NG
GIPILDI	JH AH P IH L D IY
GIPLANO	JH IH P L AH N OW
GIPONG	JH IH P AH NG
GIPRENDA	JH IH P R EH N D AH
GIPRISO	JH IH P R AH S OW
GIPROTESTAAN	JH IH P R AH T EH S T EY AH N
GIPUN	JH IH P AH N
GIPUNTINGAN	JH AH P AH N T IH N G AH N
GIPUSIL	JH IH P Y UW S AH L
GIPUTOS	JH IH P Y UW T AH Z
GIRAPIDO	JH AH R AE P AH D OW
GIREKOMENDA	JH IH R AH K AH M EH N D AH
GIRELIBHAN	JH AH R EH L AH B AH N
GIRILYA	JH AH R IH L AY AH
GISABOTAHE	JH AH S AE B AH T AH HH
GISABOTAN	JH AH S AE B AH T AH N
GISADO	JH IH S AH D OW
GISADONG	JH IH S AH D AH NG
GISAGANG	JH IH S AH G AH NG
GISAGOL	JH IH S AH G AH L
GISAKYAN	JH AH S AE K AY AH N
GISAKYANG	JH AH S AE K AY AH NG
GISALIPOD	JH AH S AE L AH P AH D
GISALOAN	JH AH S AE L OW AH N
GISAMAD	JH IH S AH M AH D
GISANDIG	JH AH S AE N D AH G
GISANGYAW	JH AH S AE N JH AY AH
GISELOSAN	JH AH S EH L AH Z AH N
GISERBISYOHAN	JH AH S AH R B AH S AY AH AH N
GISIBO	JH IH S AH B OW
GISIKOP	JH IH S AH K AH P
GISILBI	JH AH S IH L B IY
GISION	JH IH Z IY AH N
GISUDLAN	JH AH S AH D L AH N
GISUGDAN	JH AH S AH G D AH N
GISUGOT	JH AH S UW G AH T
GISULONG	JH AH S UW L AH NG
GISULTI	JH AH S AH L T IY
GISULTIHAN	JH AH S AH L T AH AH N
GISUMBONG	JH AH S AH M B AH NG
GISUMITER	JH IH S AH M AY T AH R
GISUNDAN	JH AH S AH N D AH N
GISUNOD	JH AH S UW N AH D
GISUOTAN	JH AH S UW W AH T AH N
GISUSI	JH AH S UW S IY
GISUSPETSAHAN	JH IH S AH S EH T S AH AH N
GITABANG	JH IH T AH B AH NG
GITABANGAN	JH IH T AH B AE N G AH N
GITAGAAN	JH AH T AE G EY AH N
GITAHAPAN	JH AH T AE HH AH P AH N
GITAHASAN	JH AH T AE HH AH Z AH N
GITAKLOB	JH AH T AE K L AH B
GITAMAD	JH IH T AH M AH D
GITAMBAGAN	JH AH T AE M B AH JH AH N
GITAMBALAN	JH AH T AE M B AH L AH N
GITAN	JH AY T AH N
GITANGAG	JH AH T AE N G AH G
GITANGGONG	JH AH T AE N G AH NG
GITANYAG	JH AH T AE N AY AH G
GITAPULAN	JH AH T AE P Y AH L AH N
GITARA	JH IH T AH R AH
GITAS	JH IH T AH Z
GITAWAG	JH IH T AH AH G
GITAWAGAN	JH AH T AO AH JH AH N
GITAWGAN	JH IH T AH G AH N
GITIAW	JH IH T IY AH
GITIGBAS	JH AH T IH G AH Z
GITIK	JH IH T AH K
GITIKYOPAN	JH IH T AH K AY AH P AH N
GITILAWAN	JH AH T IH L AH AH N
GITIMBAYA	JH AH T IH M B EY AH
GITIMO	JH IH T AH M OW
GITIONAN	JH AH T IY AH N AH N
GITIPIGAN	JH AH T IH P AH G AH N
GITISTINGAN	JH AH T IH S T IH N G AH N
GITORTA	JH AH T AO R T AH
GITRABAHOAN	JH IH T R AH B AE HH OW AH N
GITUBAG	JH IH T Y UW B AH G
GITUDLOAN	JH AH T AH D L OW AH N
GITUG	JH IH T AH G
GITUGKAN	JH AH T AH G K AH N
GITUGNAW	JH AH T AH G N AH
GITUGNAWKO	JH AH T AH G N AH K OW
GITULIS	JH IH T Y AH L AH S
GITUNGHAAN	JH AH T AH N EY AH N
GITUOHAN	JH IH T Y UW AH AH N
GITUOHANG	JH IH T Y UW AH HH AH NG
GITUPIHAN	JH IH T Y UW P AH AH N
GITUTOKAN	JH IH T Y UW T AH K AH N
GITUYO	JH IH T Y UW AY OW
GIUB	JH IY AH B
GIUBO	JH AY UW B OW
GIUHAW	JH AY AH HH AH
GIUKAY	JH AY UW K EY IY
GIUNA	JH AY UW N AH
GIUNAHAN	JH AY UW N AH AH N
GIUPUKAN	JH AY UW P Y UW K AH N
GIUT	JH IY AH T
GIWALA	JH IH W AH L AH
GIYA	JH AY AY AH
GLAD	G L AE D
GLORIA	G L AO R IY AH
GLUTTON	G L AH T AH N
GMA	G M AA
GN	JH IY N
GO	G OW
GOBERNADOR	G AH B AH R N AH D AH R
GOBYERNO	G AA B AY AH R N OW
GOD	G AA D
GOING	G OW IH NG
GOING(2)	G OW IH N
GOL	G AA L
GOLF	G AA L F
GOLF(2)	G AO L F
GOLI	G OW L IY
GOMA	G OW M AH
GONZALES	G AA N Z AA L AH S
GOVERNMENT	G AH V ER N M AH N T
GRAB	G R AE B
GRABE	G R EY B
GRABEHAN	G R AE B AH AH N
GRABENG	G R AE B AH NG
GRADO	G R AA D OW
GRADUATING	G R AE JH AH W EY T IH NG
GRADUATING(2)	G R AE JH UW EY T IH NG
GRADUHA	G R AE D AH HH AH
GRADUWADO	G R AH D AH W AH D OW
GRAMMAR	G R AE M ER
GRANADA	G R AH N AA D AH
GRANO	G R AA N OW
GRASYA	G R AE S AY AH
GRATEFUL	G R EY T F AH L
GRESILDA	G R AH S IH L D AH
GRIFFITHS	G R IH F IH TH S
GRIN	G R IH N
GROCERY	G R OW S ER IY
GROCERY(2)	G R OW S R IY
GROUP	G R UW P
GRUPO	G R UW P OW
GUAPA	G Y UW AH P AH
GUAPO	G Y UW AH P OW
GUARANTEE	G EH R AH N T IY
GUARD	G AA R D
GUARDIAN	G AA R D IY AH N
GUB	G AH B
GUBAT	G Y UW B AH T
GUBOT	G Y UW B AH T
GUD	G AH D
GUEST	G EH S T
GUGMA	G AH G M AH
GUGMANG	G AH G M AH NG
GUILTY	G IH L T IY
GUKOD	G Y UW K AH D
GULLAS	G AH L AH Z
GULOT	G Y UW L AH T
GUM	G AH M
GUMAGA	G Y UW M AH G AH
GUMAGAAN	G Y UW M AE G EY AH N
GUMALAYSAY	G AH M AH L EY S EY
GUMIKAN	G Y UW M AH K AH N
GUMUNHAP	G AH M AH N HH AE P
GUNA	G Y UW N AH
GUNITI	G Y UW N AH T IY
GUNMAN	G AH N M AH N
GUROYON	G Y UH R OY AH N
GURPO	G AH R P OW
GUSA	G Y UW S AH
GUSOK	G Y UW S AH K
GUSTO	G AH S T OW
GUSTOG	G AH S T AH G
GUSTONG	G AH S T AH NG
GUTLO	G AH T L OW
GUTOM	G Y UW T AH M
GUTUAL	G Y UW T Y AH W AH
GUUD	G Y UW AH D
GUWAPA	G AH W AH P AH
GUWAPO	G AH W AH P OW
GUYOD	G Y UW AY AH D
GWANTES	G W AA N T S
GWAPA	G W AA P AH
GWAPO	G W AA P OW
GWARDYA	G W AO R D AY AH
GWEN	G W EH N
GYOD	JH AY AH D
GYUD	JH AY AH D
H	EY CH
HA	HH AA
HABA	HH AE B AH
HABAGAT	HH AE B AH G AH T
HABAGATAN	HH EY B AH JH EY T AH N
HABALHABAL	HH AH B AE L HH AH B AH L
HABIG	HH AE B IH G
HABIT	HH AE B AH T
HABOL	HH AE B AH L
HADLOK	HH AE D L AH K
HADLOKON	HH AE D L AH K AH N
HAGAKHAK	HH AH G AE K AH K
HAGBAYANG	HH AE G EY AH NG
HAGDAN	HH AE G D AH N
HAGIT	HH AE JH AH T
HAGITON	HH AE JH AH T AH N
HAGKAN	HH AE G K AH N
HAGO	HH AE G OW
HAGONG	HH AE G AH NG
HAGONGAN	HH AH G AA N G AH N
HAGONOY	HH AH G AA N OW IY
HAGPATON	HH AE G P AH T AH N
HAGURUS	HH AE G Y AH R AH S
HAIN	HH EY N
HAING	HH AA IH NG
HAIR	HH EH R
HAIT	HH EY T
HAKOG	HH AE K AH G
HAKOGAN	HH AE K AH G AH N
HAKOP	HH AE K AH P
HAKOT	HH AE K AH T
HALA	HH AE L AH
HALABOS	HH AE L AH B AH Z
HALAKHAK	HH AH L AE K AH K
HALANG	HH AE L AH NG
HALAP	HH AE L AH P
HALAPAD	HH AE L AH P AH D
HALAS	HH AA L AH Z
HALAYO	HH AE L EY OW
HALF	HH AE F
HALIGI	HH AE L AH JH IY
HALIN	HH AE L AH N
HALINON	HH AE L AH N AH N
HALIYA	HH EY L IY AY AH
HALL	HH AO L
HALOGHOG	HH AE L AH AH G
HALOK	HH AE L AH K
HALOKAN	HH AE L AH K AH N
HALONG	HH AE L AH NG
HALOS	HH EY L OW Z
HAMBOG	HH AE M B AO G
HAMBOGERO	HH AE M B AA JH AH R OW
HAMBUG	HH AE M B AH G
HAMIS	HH AE M IY Z
HAMON	HH AE M AH N
HAMONADO	HH AE M AO N AH D UW
HAMTONG	HH AE M T AA NG
HAMUBONG	HH AE M Y UW B AH NG
HAMUGAWAY	HH AE M Y AH G AO EY IY
HANAP	HH AE N AH P
HANAS	HH AE N AH Z
HANAW	HH AE N AH
HANDCUFF	HH AE N D K AH F
HANDGUN	HH AE N D G AH N
HANDHELD	HH AE N D HH EH L D
HANDOM	HH AE N
HANDOMON	HH AE N D AH M AH N
HANDSOME	HH AE N S AH M
HANDUMANAN	HH AE N D Y UW M AH N AH N
HANDWRITING	HH AE N D R AY T IH NG
HANG	HH AE NG
HANGGA	HH AE N G AH
HANGIN	HH AE NG IH N
HANGINON	HH AE NG IH N AO N
HANGTOD	HH AE N G T AH D
HANGTUD	HH AE N G T AH D
HANGYO	HH AE N JH AY OW
HANGYOON	HH AE N JH AY UW N
HANTAK	HH AE N T AH K
HAP	HH AE P
HAPAK	HH AE P AH K
HAPAKON	HH AE P AH K AH N
HAPDOS	HH AE P D UW Z
HAPIN	HH AE P IH N
HAPIT	HH AE P AH T
HAPON	HH AE P AO N
HAPONES	HH AH P OW N Z
HAPPY	HH AE P IY
HAPSAY	HH AE P S EY
HARA	HH EH R AH
HARDIN	HH AA R D IH N
HARI	HH AA R IY
HARNATA	HH AA R N AH T AH
HARUHAY	HH AH R AH HH EY IY
HASHASAN	HH AE SH AH Z AH N
HASKANG	HH AE S AH NG
HASMAG	HH AE Z M AH G
HASOHASAN	HH AH S AA HH AH Z AH N
HASOLON	HH AE S AH L AH N
HASTA	HH AE S T AH
HASTA(2)	AA S T AH
HATAG	HH AE T AH G
HATAGAN	HH EY T AH JH AH N
HATDOG	HH AE T D AO G
HATSA	HH AE T S AH
HAVE	HH AE V
HAW	HH AO
HAWA	HH AO AH
HAWAK	HH AO AH K
HAWAN	HH AO AH N
HAWANAN	HH AO AH N AH N
HAWLA	HH AO L AH
HAWSING	HH AO Z IH NG
HAYA	HH EY AH
HAYAG	HH EY AH G
HAYAHAY	HH EY AH HH EY
HAYANG	HH EY AH NG
HAYAON	HH EY AH AO N
HAYOP	HH EY AH P
HAYSKUL	HH EY S AH L
HAYWEY	HH EY W IY
HEADS	HH EH D Z
HELEN	HH EH L AH N
HELIKOPTER	HH EH L AH K AA P T AH R
HELLO	HH AH L OW
HELLO(2)	HH EH L OW
HELMET	HH EH L M AH T
HELPER	HH EH L P ER
HENRY	HH EH N R IY
HEPE	HH IY P
HERE	HH IY R
HI	HH AY
HIBALOAN	HH AH B AE L OW AH N
HIBILYA	HH AH B IH L AY AH
HIBLA	HH IH B L AH
HIDLAW	HH IH D L AO
HIGA	HH IY G AH
HIGALA	HH IH G AH L AH
HIGANTE	HH IH G AH N T
HIGAYON	HH IH G EY AH N
HIGAYONA	HH AH G EY AH N AH
HIGAYUNA	HH IH G EY UW N AH
HIGDA	HH IH G D AH
HIGDAAN	HH IH G D EY AH N
HIGDAANAN	HH IH G D AH N AH N
HIGH	HH AY
HIGHLIGHT	HH AY L AY T
HIGUGMA	HH AH G AH G M AH
HIGUT	HH IH G AH T
HII	HH IY
HIKATULOG	HH AH K AE T Y UW L AH G
HIKAY	HH IH K EY IY
HIKAYON	HH IH K EY AH N
HIKO	HH IH K OW
HIKTIN	HH IH K T AH N
HIKUT	HH IH K AH T
HILABTANON	HH AH L AE B T AH N AH N
HILAK	HH IH L AH K
HILAKA	HH IH L AH K AH
HILAM	HH IH L AH M
HILAMON	HH IH L AH M AH N
HILANAT	HH IH L AH N AH T
HILANGHILANG	HH AH L AE N AH L AH NG
HILAS	HH IH L AH Z
HILAW	HH IH L AH
HILAWAS	HH IH L AH AH Z
HILIG	HH IH L AH G
HILOM	HH IH L AH M
HILUM	HH AY L AH M
HILUMON	HH AY L AH M AO N
HIMALITAN	HH AH M AE L AH T AH N
HIMAN	HH AY M AH N
HIMAS	HH IH M AH Z
HIMATNGONI	HH AH M AE T N G AH N IY
HIMAYA	HH IH M EY AH
HIMO	HH IH M OW
HIMOON	HH AH M UW N
HIMOONG	HH AH M UW NG
HIMSOG	HH IH M Z AH G
HIMUON	HH IH M Y UW AH N
HIMUOT	HH IH M Y UW AH T
HINABANG	HH IH N AH B AH NG
HINAGIBAN	HH AH N AE JH AH B AH N
HINAGUAN	HH AH N AE G Y UW AH N
HINALI	HH IH N AH L IY
HINAMBOG	HH AH N AE M B AH G
HINATAG	HH IH N AH T AH G
HINATAGAN	HH AY N AH T AH JH AH N
HINAY	HH IH N EY IY
HINAYA	HH IH N EY AH
HINAYAN	HH IH N EY AH N
HINAYHINAY	HH IH N AH HH IH N EY IY
HINAYON	HH IH N EY AH N
HINDI	HH IH N D IY
HINGIGO	HH IH N JH AH G OW
HINGILIN	HH IY IH NG IH L IH N
HINGPIT	HH IY IH NG P IH T
HINGTUNGDAN	HH IH N G T AH N G D AH N
HINHIN	HH IH N HH AH N
HINIGUGMA	HH IH N AH G AH G M AH
HINIMO	HH IH N AH M OW
HINIPUNAN	HH IH N AH P Y UW N AH N
HINIRAM	HH IH N AH R AH M
HINIUSA	HH IH N IY UW S AH
HINLO	HH IH N L OW
HINOG	HH IH N AH G
HINOON	HH AH N UW N
HINOOY	HH IH N UW IY
HINTUTUDLO	HH IH N T Y AH T AH D L OW
HINUBOG	HH IH N Y UW B AH G
HINUGON	HH IH N Y UW G AH N
HINUHULI	HH IH N AH HH Y UW L IY
HINULTI	HH AH N AH L T IY
HINUMDOMI	HH AH N AH M D AH M IY
HINUMDUM	HH AH N AH M D AH M
HINUNGDAN	HH AH N AH N G D AH N
HINUNGDANG	HH AH N AH N G D AH NG
HINUNGDANON	HH AH N AH N G D AH N AH N
HINUON	HH IH N Y UW AH N
HIPON	HH IH P AO N
HIPUSA	HH IH P Y UW S AH
HIRAM	HH AY R AH M
HIRAP	HH IH R AH P
HIRINGGILYA	HH IH R AH N JH IH L AY AH
HISAKPON	HH AH S AE K AH N
HISGAOTI	HH IH Z EY AH T IY
HISGOT	HH AY Z G AA T
HISGOTAN	HH AY Z G OW T AE N
HISGOTANAN	HH IH Z AA T AH N AH N
HISGUTI	HH IH Z Y AH T IY
HISTORIAN	HH IH S T AO R IY AH N
HISTORYADOR	HH IH S T AH R IY EY D ER
HITAAS	HH IH T AH Z
HITABO	HH IH T AH B OW
HITSURA	HH IH T S AH R AH
HIUSA	HH AY UW S AH
HIUSAON	HH AY UW S EY AH N
HIYAS	HH AY AY AH Z
HO	HH OW
HOLY	HH OW L IY
HOMICIDE	HH AA M AH S AY D
HOMO	HH OW M OW
HOMQUILADA	HH AA M K W IH L AH D AH
HONHON	HH AA N HH AH N
HOPYA	HH AA P AY AH
HOSPITAL	HH AA S P IH T AH L
HOST	HH OW S T
HOSTESS	HH OW S T AH S
HOT	HH AA T
HOTEL	HH OW T EH L
HOUR	AW ER
HOUR(2)	AW R
HOUSE	HH AW S
HOYOHOY	HH OY AA HH OW IY
HUA	HH UW AH
HUA(2)	HH W AA
HUBAG	HH Y UW B AH G
HUBAK	HH Y UW B AH K
HUBAKON	HH Y UW B AH K AH N
HUBARA	HH Y UW B AH R AH
HUBARON	HH AH B ER AO N
HUBO	HH Y UW B OW
HUBOG	HH Y UW B AH G
HUDIYO	HH Y UW D IY AY OW
HUDNO	HH AH D N OW
HUDNOHAN	HH AH D N AH AH N
HUGAW	HH Y UW G AH
HUGNA	HH AH G N AH
HUGNO	HH AH G N OW
HUGOT	HH Y UW G AH T
HUGOTHUOT	HH Y UW G AH TH UW W AH T
HUGPONG	HH AH G P AH NG
HUGUT	HH Y UW G AH T
HUHOD	HH AH HH AH D
HULAGWAY	HH Y UW L AE G W EY IY
HULAM	HH Y UW L AH M
HULAT	HH Y UW L AH T
HULATA	HH Y UW L AH T AH
HULATI	HH Y UW L AH T IY
HULATON	HH Y UW L AH T AH N
HULAW	HH Y UW L AH
HULING	HH Y UW L IH NG
HULING(2)	Y UW L IH NG
HULIP	HH Y UW L AH P
HULMA	HH AH L M AH
HULMIGAS	HH AH L M AH G AH Z
HULYO	HH Y UW L AY OW
HUMAHAPAK	HH Y UW M AE HH AH P AH K
HUMAN	HH Y UW M AH N
HUMAN(2)	Y UW M AH N
HUMANA	HH Y UW M AE N AH
HUMAWAK	HH Y UW M AH AH K
HUMAY	HH Y UW M EY IY
HUMOK	HH Y UW M AH K
HUMOR	HH Y UW M ER
HUMOT	HH Y UW M AH T
HUNA	HH Y UW N AH
HUNAHUNA	HH Y UW N AH HH Y UW N AH
HUNAHUNAA	HH Y UW N AH HH Y UW N AH
HUNAS	HH Y UW N AH Z
HUNDRED	HH AH N D R AH D
HUNDRED(2)	HH AH N D R IH D
HUNDRED(3)	HH AH N ER D
HUNDRED(4)	HH AH N D ER D
HUNGHONG	HH AH N AH NG
HUNGOG	HH AH N G AH G
HUNGRY	HH AH NG G R IY
HUNI	HH Y UW N IY
HUNIT	HH Y UW N AH T
HUNONG	HH Y UW N AH NG
HUNYO	HH Y UW N AY OW
HUOT	HH Y UW AH T
HURADO	HH Y UH R AH D OW
HURAL	HH Y UH R AH L
HUSAYON	HH Y UW S EY AH N
HUSTISYA	HH AH S T IH S AY AH
HUSTO	HH AH S T OW
HUT	HH AH T
HUWATON	HH AH W AH T AH N
HUWAW	HH AH W AH
HUWEBES	HH AH W IY B Z
HUWES	HH AH W Z
HUYOHOY	HH Y UW AY AA HH OW IY
HUYOP	HH Y UW AY AH P
HUYPANAN	HH Y UW IH P AH N AH N
HUYUP	HH Y UW IY AH P
HWEBES	W IY B Z
HYPOCRITE	HH IH P AH K R IH T
I	AY
IBA	IY B AH
IBABAW	IH B AH B AH
IBALHIN	AH B AE L HH AH N
IBALIGYA	IH B AH L IH JH AY AH
IBALIK	IH B AH L AH K
IBALITA	AH B AE L AH T AH
IBALIWALA	IH B AH L IH W AH L AH
IBANAN	IH B AH N AH N
IBAY	IH B EY IY
IBLATER	IH B L EY T AH R
IBOG	IH B AH G
IBUKA	IH B Y UW K AH
IBUNGAT	AH B AH N G AH T
IBUTANG	IH B Y UW T AH NG
IBUTYAG	IH B Y UW T AY AH G
ICALINA	AH K AE L AH N AH
IDAD	IH D AH D
IDAGAN	AY D AH JH AH N
IDAP	IH D AH P
IDAPAT	IH D AH P AH T
IDEYA	IH D EY AH
IDIYA	AH D IY AY AH
IDMB	IH D M
IDOLO	IH D AH L OW
IDTO	IH D T OW
IDUKO	IH D Y UW K OW
IDUOL	IH D Y UW AH L
IE	AY
IG	IH G
IGABIT	IH G AH B AH T
IGAGAW	IH G AH G AH
IGAHIN	IH G AH HH AH N
IGALAWOG	AH G AE L AH AH G
IGBABATIL	IH G AE B AH T AH L
IGBAW	IH G AH
IGNORANTE	IH G N AH R AH N T
IGO	IY G OW
IGONG	IH G AH NG
IGOS	IH G AH Z
IGPALAGSIK	IH G P AH L AE G S AH K
IGSO	IH G S OW
IGSOON	IH G S UW N
IGSOONG	IH G S UW NG
IGSU	IH G S UW
IGSUON	IH G S UW W AH N
IGTAGSA	IH G T AE G S AH
IGTAGURHA	IH G T AE G AH R AH
IGUT	IH G AH T
IHALAS	IH HH AH L AH Z
IHAP	IH HH AH P
IHATAG	IH HH AH T AH G
IHATOD	IH HH AH T AH D
IHAWAN	IH HH AH AH N
IHI	IH HH IY
IHIANAN	AH HH IY AH N AH N
IHIGOT	IH HH AH G AH T
IHON	IH HH AH N
IHULAGWAY	IH HH Y AH L AE G W EY IY
IHULOG	IH HH Y UW L AH G
IHUMUGSO	IH HH Y AH M AH G S OW
IHUNONG	IH HH Y UW N AH NG
IIHAW	IY HH AH
IILIS	AY AH L AH S
IISKWELA	IY S W AH L AH
IK	IH K
IKA	IH K AH
IKABAEANTE	AH K AE B IY AH N T
IKABAYLOG	IH K AH B EY L AH G
IKABEINTE	IH K AH B IY N T
IKABIENTE	IH K AH B IY N T
IKABILYON	IH K AH B IH L AY AH N
IKABUBUHAY	AH K AE B Y AH B AH HH EY IY
IKADASIG	AH K AE D AH S AH G
IKADAYEG	AH K AE D EY AH G
IKADISINWEBE	AH K AH D IH S AH N W IY B
IKADISIOTSO	AH K AE D AH S IY AA T S OW
IKADISISAAAS	IH K AH D AH S IH S AH AH Z
IKADISISAIS	IH K AH D AH S IH S EY AH S
IKADISISYACTE	IH K AH D AH S IH S AY AH K T
IKADISISYETE	AH K AH D AH S IH S AY IY T
IKADOSE	IH K AH D OW Z
IKADUHA	AH K AE D AH HH AH
IKADUHANG	AH K AE D AH HH AH NG
IKAHATAG	AH K AE HH AH T AH G
IKAHATOD	AH K AE HH AH T AH D
IKAKINSE	IH K AH K AH N S
IKALIMA	AH K AE L AH M AH
IKANAPULO	IH K AH N AH P Y UW L OW
IKANUBENTA	AH K AE N Y AH B EH N T AH
IKAONSE	IH K EY AH N S
IKAPAMAHAW	IH K AH P AE M AH HH AH
IKAPANGHIMAKAK	IH K AH P AH N IH M AH K AH K
IKAPASAKA	IH K AH P AE S AH K AH
IKAPASIDUNGOG	AH K AE P AH S AH D AH N G AH G
IKAPILA	AH K AE P AH L AH
IKAPITO	AH K AE P AH T OW
IKASAISENTA	IH K AH S AH S EH N T AH
IKASITENTA	IH K AH S AH T EH N T AH
IKASIYAM	IH K AH S IY AY AH M
IKATAMBAG	IH K AH T AE M B AH G
IKATATLUMPUT	IH K AH T AH T L AH M P AH T
IKATIMO	AH K AE T AH M OW
IKATOLONG	AH K AE T AH L AH NG
IKATORSE	IH K AH T AH R S
IKATRACSE	AH K AE T R AH K S
IKATRESE	IH K AH T R IY Z
IKATULO	IH K AH T Y UW L OW
IKATULONG	IH K AH T Y UW L AH NG
IKATUNOL	IH K AH T Y UW N AH L
IKAUNUM	IH K AH N AH M
IKAUPAT	IH K AH P AH T
IKAW	IH K AH
IKAWALO	AH K AO AH L OW
IKAYUHOT	AH K EY AH HH AH T
IKIHA	IH K AH HH AH
IKOG	IH K AH G
IKSAKTO	IH K S AE K T OW
IKUHA	IH K AH HH AH
IKUNSULTA	IH K AH N S AH L T AH
IKUWENTO	IH K AH W EH N T OW
IKYAS	IH K AY AH Z
ILA	IY L AH
ILAGA	IH L AH G AH
ILAHA	IH L AH HH AH
ILAILA	AH L EY L AH
ILAKIP	IH L AH K AH P
ILALUM	IH L AE L AH M
ILANG	IH L AH NG
ILARAWAN	AH L AE R AH AH N
ILAWOM	IH L AH AH M
ILEGAL	IH L AH G AH L
ILHANAN	IH L HH AH N AH N
ILHI	IH L HH IY
ILIGAL	IH L AH G AH L
ILIMNON	AH L IH M N AH N
ILIS	AY L AH S
ILISTA	AH L IH S T AH
ILIW	IH L AH W
ILL	IH L
ILLEGAL	IH L IY G AH L
ILO	AY L OW
ILOG	IH L AH G
ILOILO	AH L OY L OW
ILOK	IH L AH K
ILONG	IH L AH NG
ILUBONG	AH L UW B AH NG
ILUK	IH L AH K
ILUSTRAR	AH L AH S T R AH R
IMAGE	IH M AH JH
IMAGE(2)	IH M IH JH
IMAGINATION	IH M AE JH AH N EY SH AH N
IMBENTO	IH M B AH N T OW
IMBESTIGA	IH M B AH S T IH G AH
IMBESTIGADOR	IH M B AH S T IH G AH D AH R
IMBESTIGAHON	IH M B AH S T IH G AH HH AH N
IMBESTIGARON	IH M B AH S T IH G AH R AH N
IMBESTIGASYON	IH M B AH S T AH G AE S AY AH N
IMBIS	IH M B AY Z
IMBITAR	IH M B AY T AA R
IMBITARA	IH M B AH T AE R AH
IMBITARON	IH M B AY T AA R AO N
IMBITASYON	IH M B AH T AE S AY AH N
IMBORNAL	IH M B AO R N AH L
IMIGRANTE	AH M IH G R AH N T
IMNA	IH M N AA
IMNANAN	IH M N EY N AH N
IMNON	IH M N AA N
IMNONON	IH M N AA N AO N
IMO	AY M OW
IMO(2)	AY EH M OW
IMOK	AH M AA K
IMONG	AH M AO NG
IMPAK	IH M P AE K
IMPATSO	IH M P AE T S OW
IMPEKSYON	IH M P EH K S AY AH N
IMPERNO	IH M P AH R N OW
IMPINYUHON	IH M P AH N AY AH HH AH N
IMPLIKASYON	IH M P L AH K AE S AY AH N
IMPLUWENSYA	IH M P L AH W EH N S AY AH
IMPORMASYON	IH M P AO R M AE S AY AH N
IMPORTANTE	IH M P AO R T AH N T
IMPOSIBLE	IH M P OW Z AH B AH L
IMPRASTRAKTURA	IH M P R AE S T R AE K T Y AH R AH
IMPRESIBO	IH M P R AH S IH B OW
IMPRESYON	IH M P R AH S AY AH N
IMPROVISED	IH M P R AH V AY Z D
IMPUNTO	IH M P AH N T OW
IMPYERNO	IH M P AY AH R N OW
IN	IH N
INABAGAN	AH N EY B AH JH AH N
INADLIP	AH N AE D L AH P
INAHAN	AH N AE AH N
INAINA	AH N EY N AH
INASAL	AH N EY Z AH L
INATO	AH N AE T OW
INATOATO	AH N AH T OW T OW
INAY	AH N EY IY
INAYAGAN	AH N EY AH JH AH N
INAYAWAN	AH N EY AH AH N
INCORPORATED	IH N K AO R P ER EY T IH D
INDAY	IH N D EY
INDEKS	IH N D EH K S
INDEPENDENTE	IH N D AH P EH N D AH N T
INDIAN	IH N D IY AH N
INDIBIDUWAL	IH N D AH B IH D AH W AH L
INDIGAY	IH N D IH G EY IY
INDIKASYON	IH N D AH K AE S AY AH N
INDUSTRIYA	IH N D AH S T R IY AY AH
INDUSTRIYAL	IH N D AH S T R IY IY AH L
INFLATION	IH N F L EY SH AH N
ING	IH NG
INGLE	IH NG G AH L
INGNA	IH N AA
INGNAN	IH N G N AH N
INGON	IH N G AA N
INGONG	IH N G AO NG
INGUSNGUS	IH N G AH Z N G AH S
INHABITANT	IH N HH AE B IH T AH N T
INHUSTISYA	IH N HH AH S T IH S AY AH
INI	AH N IY
INIDORO	AH N IH D AH R OW
INIG	AH N IH G
INIGKAHAPON	AH N IH G K AE HH AH P AH N
INIGKAHUMAN	AH N IH G K AH HH Y UW M AH N
INIGKAKUHA	AH N IH G K AE K AH HH AH
INIGSOON	AH N IH G S UW N
INILA	AH N IH L AH
INISTORYAHAN	AH N IH S T AH R AY AH AH N
INISYAL	IH N IY Z IY AH L
INISYATIBA	AH N IH S AY AE T AH B AH
INIT	AH N IH T
INJECTION	IH N JH EH K SH AH N
INOM	AH N AA M
INOSENTE	AH N AA S AH N T
INOT	AH N AA T
INQUISITION	IH N K W AH Z IH SH AH N
INSANE	IH N S EY N
INSEDENTI	IH N S AH D EH N T IY
INSEKTO	IH N S EH K T OW
INSENTIBO	IH N S EH N T AH B OW
INSIDENTE	IH N S IH D AH N T
INSIDENTI	IH N S AH D EH N T IY
INSISTER	IH N S IH S T ER
INSOLENT	IH N S AH L AH N T
INSP	IH N S
INSPEKSYON	IH N S EH K S AY AH N
INSPEKSYONON	IH N S EH K S AY AH N AH N
INSTALAR	IH N S T AH L ER
INSTALLMENT	IH N S T AO L M AH N T
INSTITUSYON	IH N Z T IH T Y UW S IY AO N
INSTITUSYONAL	IH N Z T IH T Y UW S IY AO N AH L
INSTRUKSIYON	IH N S T R AH K S IY AY AH N
INSTRUKTOR	IH N S T R AH K T AH R
INSTRUMENTO	IH N S T R AH M EH N T OW
INSULTO	IH N S AH L T OW
INTAWON	IH N T AO AH N
INTELIHENTE	IH N T EH L AH HH AH N T
INTELLECTUAL	IH N T AH L EH K CH UW AH L
INTELLECTUAL(2)	IH N AH L EH K CH UW AH L
INTELLIGENCE	IH N T EH L AH JH AH N S
INTERAKSYON	IH N T AH R AE K S AY AH N
INTERBENSYON	IH N T ER B IY AH N Z IY AO N
INTERES	IH N T IY R Z
INTERESADO	IH N T AH R EH S AH D OW
INTERNAL	IH N T ER N AH L
INTERNASYONAL	IH N T AH R N AH S AY AH N AH L
INTERNATIONAL	IH N T ER N AE SH AH N AA L
INTERNATIONAL(2)	IH N ER N AE SH AH N AA L
INTERNET	IH N T ER N EH T
INTERO	IH N T AH R OW
INTERPRETASYON	IH N T AH R P R AH T AE S AY AH N
INTERVIEW	IH N T ER V Y UW
INTRIGA	IH N T R IH G AH
INTSIK	IH N T S IH K
INUN	AH N AH N
INUSARA	IH N Y UW S AH R AH
INUSARANG	IH N Y UW S AH R AH NG
INUTIL	IH N Y UW T AH L
INVESTIGATION	IH N V EH S T AH G EY SH AH N
INYO	IH N Y OW
INYONG	IH N Y AO NG
INYUDURO	IH N Y UW D Y AH R OW
IPA	IH P AH
IPAABOT	IH P AH B AH T
IPAADMIT	AH P AA D M AH T
IPAAGI	IH P AH JH IY
IPABUHAT	AH P AE B AH HH AH T
IPADALA	AH P AE D AH L AH
IPADAYON	AH P AE D EY AH N
IPADILIBER	AH P AE D AH L AY B AH R
IPAGUYOD	AH P AE G W AY AH D
IPAHAYAG	AH P AE HH EY AH G
IPAHIANGAY	IH P AH HH IY AE N G EY IY
IPAHIBALO	IH P AH HH IH B AH L OW
IPAHIBAWO	IH P AH HH IH B AH OW
IPAHIGAYON	IH P AH HH IH G EY AH N
IPAHIMUTANG	IH P AH HH AH M Y UW T AH NG
IPAHUGAS	IH P AH HH Y UW G AH Z
IPAILAILA	IH P AH L EY L AH
IPAKASAL	AH P AE K AH Z AH L
IPAKITA	AH P AE K AH T AH
IPAKITAA	AH P AE K AH T AH
IPALABOG	AH P AE L AH B AH G
IPALIWANAG	IH P AH L IH W AH N AH G
IPAMANEHO	IH P AH M AE N AH HH OW
IPANGHIMAKAK	IH P AH N IH M AH K AH K
IPANGUTANA	IH P AH N G Y UW T AH N AH
IPANINGALA	IH P AH N IH N G AH L AH
IPAPANGITA	IH P AH P AE N JH AH T AH
IPAPIK	IH P AH P AH K
IPAREHAS	AH P AE R AH HH AH Z
IPARES	IH P AH R Z
IPASA	IH P AH S AH
IPASABOT	AH P AE S AH B AH T
IPASABUT	AH P AE S AH B AH T
IPASAKA	AH P AE S AH K AH
IPASAYLO	IH P AH S EY L OW
IPASIUGDA	AH P EY S IY AH G D AH
IPATAGNA	IH P AH T AE G N AH
IPATIMBANG	IH P AH T IH M B AH NG
IPATUMAN	IH P AH T Y UW M AH N
IPATUMAR	IH P AH T Y UW M AH R
IPIT	IH P AH T
IPON	IH P AH N
IPRESENTA	IH P R AH S EH N T AH
IPRESENTAR	IH P R AH S EH N T AH R
IPRESS	IH P R AH S
IPRINT	IH P R AH N T
IPRISO	IH P R AH S OW
IPU	IH P UW
IPUNDOK	AH P AH N D AH K
IPUTOS	IH P Y UW T AH Z
IPUYO	IH P Y UW AY OW
IRAQI	IH R AE K IY
IRAQI(2)	IY R AE K IY
IRAQI(3)	AY R AE K IY
IREKLAMO	AH R EH K L AH M OW
IREPORT	AY ER P OW R T
IRING	AY ER IH NG
IRISH	AY R IH SH
IRO	IH R OW
IROG	IH R AH G
IRON	AY ER N
IS	IH Z
ISA	IY S AH
ISAGANI	AH S AE G AH N IY
ISALIKWAY	IH S AH L IH K W EY IY
ISALIYAB	IH S AH L IY AY AH B
ISAN	AY Z AH N
ISAULI	IH S AH L IY
ISAYSAY	AH S EY S EY IY
ISDA	IH Z D AH
ISEGURO	AH S EH G Y AH R OW
ISIG	IH S AH G
ISIGKA	AH S IH G K AH
ISIGKAKASINGKASING	AH S AH G K AH K AE S AH N G K EY Z AH NG
ISINUKSOK	IH S AH N AH K S AH K
ISIP	IH S AH P
ISIRA	IH S AH R AH
ISIRI	IH S AH R IY
ISKA	IH S AH
ISKEDYUL	IH S EH D AY AH L
ISKETING	IH S IY T AH NG
ISKUL	IH S AH L
ISLA	IY L AH
ISLAMIKO	IH Z L AE M AH K OW
ISMAGLING	IH Z M AE G L AH NG
ISNABERA	AY Z N AE B IH R AH
ISOG	IH S AH G
ISPONSOR	IH S AA N S AH R
ISPORT	AY Z P OW R T
ISRAELI	IH Z R EY L IY
ISTADO	IH S T AH D OW
ISTAKAHAN	IH S T AE K AH AH N
ISTASYON	IH S T AE S AY AH N
ISTAYL	IH S T EY L
ISTORYA	IH S T AO R AY AH
ISTORYAHAN	IH S T AH R AY AH AH N
ISTORYAHON	IH S T AH R AY AH HH AH N
ISTRIKTO	IH S T R IH K T OW
ISUG	IH S AH G
ISUGILON	AH S UW JH AH L AH N
ISUKOD	AH S UW K AH D
ISUKSOK	AH S AH K S AH K
ISULAT	AH S UW L AH T
ISULTI	AH S AH L T IY
ISUMBONG	AH S AH M B AH NG
ISUNGAG	AY Z AH N G AE G
ISUROY	AH S UH R OW IY
ISUSUWAT	AH S UW S AH W AH T
ISYU	IH S AY UW
ISYUHAN	AH S AY AH AH N
ITAAS	IH T AH Z
ITABO	IH T AH B OW
ITAGO	IH T AH G OW
ITALYANO	IH T AH L AY AH N OW
ITANDI	AH T AE N D IY
ITANOM	IH T AH N AH M
ITANUM	IH T AH N AH M
ITIK	IH T AH K
ITIMPLA	AH T IH M P L AH
ITLOG	IH T L AH G
ITOM	IH T AH M
ITOMON	IH T AH M AH N
ITSA	IH T S AH
ITSAHAN	IH T S AH AH N
ITUDLO	AH T AH D L OW
ITUGOT	IH T Y UW G AH T
ITUM	IH T AH M
ITUMON	IH T Y UW M AH N
ITUNOL	IH T Y UW N AH L
IULI	AY AH L IY
IWAKSI	AH W AE K S IY
IWASAN	IH W AH Z AH N
IWAYON	IH W EY AH N
IYA	AY AY AH
IYAAN	AY AY EY AH N
IYAHAN	AY AY AH AH N
IYANG	AY AY AH NG
IYO	AY AY OW
IYONG	AY AY AH NG
JABONERO	JH AH B AA N AH R OW
JAMES	JH EY M Z
JANICE	JH AE N AH S
JANICE(2)	JH AE N IH S
JAYVEE	JH EY V IY IY
JEROL	JH EH R AH L
JESU	JH EH S UW
JET	JH EH T
JOAVAN	JH OW V AH N
JOEFREY	JH OW EH F R IY
JOGGING	JH AA G IH NG
JOGGING(2)	JH AO G IH NG
JOHN	JH AA N
JOURNAL	JH ER N AH L
JOVITO	JH OW V IY T OW
JR	JH EY R
JUAN	W AA N
JUAN(2)	HH W AA N
JUD	JH AH D
JUDGE	JH AH JH
JULIA	JH UW L Y AH
JULIO	JH UW L IY OW
JULIO(2)	HH UW L IY OW
JUNIOR	JH UW N Y ER
JUVENILE	JH UW V AH N AH L
JUVENILE(2)	JH UW V AH N AY L
KA	K AA
KAABAG	K AA B AH G
KAABAY	K AA B EY IY
KAADLAWAN	K AA D L AH AH N
KAADLAWON	K AA D L AH AH N
KAADTOAN	K AA D T OW AH N
KAAGI	K AA JH IY
KAALAM	K AA L AH M
KAALYADO	K AH L AY AH D OW
KAAMBONG	K AA M B AH NG
KAANGHIT	K AA N AH T
KAANHA	K AA N HH AH
KAANYAG	K AA N AY AH G
KAAWAAW	K AA W AH W
KAAWAY	K AA W EY IY
KAAYO	K AA AY OW
KAAYOG	K AA AY AH G
KAAYOHAN	K AA AY AH AH N
KAAYONG	K AA AY AH NG
KAAYUNAY	K AA AY UW N EY IY
KABAHIN	K AE B AH HH AH N
KABALAKA	K AH B AE L AH K AH
KABALAYAN	K AH B AE L EY AH N
KABALO	K AE B AH L OW
KABAN	K EY B AH N
KABANAY	K AH B AE N EY IY
KABANAYAN	K AH B AE N EY AH N
KABANDILAAN	K AH B AE N D IH L EY AH N
KABANGKAAGAN	K AH B AE N G K EY AH JH AH N
KABANWA	K AH B AE N W AH
KABARKADA	K AH B AA R K AH D AH
KABARYOHAN	K AE B AH R AY AH AH N
KABASKOG	K AH B AE S AH G
KABATAAN	K AH B AE T EY AH N
KABATAN	K EY B EY T AH N
KABATAON	K AH B AE T EY AH N
KABAW	K AE B AH
KABAWA	K AE B AH AH
KABAYO	K AE B EY OW
KABILIN	K AE B AH L AH N
KABISADO	K AH B IH S AH D OW
KABIT	K AE B AH T
KABKAB	K AE B K AH B
KABKAD	K AE B K AH D
KABLE	K EY B AH L
KABO	K AE B OW
KABOG	K AE B AH G
KABOMBEROHAN	K AH B AA M B EH R AH AH N
KABOS	K AE B AH Z
KABTANGAN	K AE B T AE N G AH N
KABUBUT	K AE B Y UW B AH T
KABUGHAW	K AE B AH AH
KABUHI	K AE B AH HH IY
KABUHIAN	K AH B AH IY AH N
KABUHONG	K AE B AH HH AH NG
KABUKIRAN	K AE B Y UW K AH R AH N
KABULAN	K AE B Y AH L AH N
KABULUHANAN	K AE B Y AH L AH HH AH N AH N
KABUNTAGON	K AH B AH N T AH G AH N
KABUOK	K AE B Y UW AH K
KABUS	K EY B AH S
KABUTA	K AE B Y UW T AH
KABUTANG	K AE B Y UW T AH NG
KADA	K AE D AH
KADAAN	K AE D EY AH N
KADAGATAN	K EY D AH JH EY T AH N
KADAGHAN	K AE D AH AH N
KADAGHANAN	K AH D AE AH N AH N
KADAGHANON	K AH D AE AH N AH N
KADAGKOAN	K AH D AE G K OW AH N
KADAKO	K AE D AH K OW
KADALANAN	K AH D AE L AH N AH N
KADALI	K AE D AH L IY
KADAOT	K AE D EY AH T
KADASIG	K AE D AH S AH G
KADAUGAN	K AE D AH G AH N
KADAUTAN	K AE D AH Y UW T AH N
KADAWAT	K AE D AH AH T
KADAWO	K AE D AH OW
KADENA	K AE D AH N AH
KADETE	K AH D IY T
KADIYOT	K EY D IY AY AH T
KADIYUT	K EY D IY AY AH T
KADLAWON	K AE D L AH AH N
KADTO	K AE D T OW
KADTOG	K AE D T AH G
KADTONG	K AE D T AH NG
KADUGAY	K AE D Y UW G EY IY
KADUGAYAN	K AE D Y UW G EY AH N
KADUGO	K AE D Y UW G OW
KADUHA	K AE D AH HH AH
KADULA	K AE D Y UW L AH
KADUNGAN	K AH D AH N G AH N
KADUNGGANAN	K AH D AH N G AH N AH N
KADYOT	K AE D AY AH T
KADYUT	K AE D AY AH T
KAG	K AE G
KAGAB	K AE G AH B
KAGABHION	K AH G AE B IY AH N
KAGABI	K AE G AH B IY
KAGABII	K AH G EY B IY
KAGAHAPON	K AH G AE HH AH P AH N
KAGAMITAN	K AH G AE M AH T AH N
KAGANINA	K AH G AE N AH N AH
KAGAW	K AE G AH
KAGAWASAN	K AH G AO AH Z AH N
KAGIKANAN	K AH JH IH K AH N AH N
KAGINHAWAAN	K AH JH IH N HH AO EY AH N
KAGIW	K AE JH AH W
KAGUBOT	K AE G Y UW B AH T
KAGULKOL	K AH G AH L K AH L
KAGUTOM	K AE G Y UW T AH M
KAGUUL	K AE G W AH L
KAHA	K AE HH AH
KAHADLOK	K AH HH AE D L AH K
KAHAMTONG	K AH HH AE M T AH NG
KAHANGINAN	K AH HH AE N JH AH N AH N
KAHANGTORAN	K AH HH AE N G T AH R AH N
KAHAPON	K AE HH AH P AH N
KAHAPONON	K AH HH AE P AH N AH N
KAHARUHAY	K AE HH AH R AH HH EY IY
KAHASUL	K AE HH AH S AH L
KAHATAGAN	K AE AH T AH JH AH N
KAHAW	K AE HH AH
KAHAYAG	K AE HH EY AH G
KAHERA	K AE HH AH R AH
KAHIBALO	K AH HH IH B AH L OW
KAHIBALUAN	K AH HH IH B AH L UW W AH N
KAHIBAW	K AE HH AH B AH
KAHIBULONG	K AE HH AH B Y UW L AH NG
KAHIBULUNGAN	K AH HH IH B Y AH L AH N G AH N
KAHIGALAAN	K AE HH AH G AE L EY AH N
KAHIGAYONAN	K AE HH AH G EY AH N AH N
KAHIGAYUNAN	K AH HH IH G EY UW N AH N
KAHIKAYAN	K AH HH IH K EY AH N
KAHIL	K AE HH AH L
KAHILANATON	K AE HH AH L AE N AH T AH N
KAHILISAN	K AE IH L AH S AH N
KAHIMATNGON	K AE HH AH M AE T N G AH N
KAHIMSOG	K AH HH IH M Z AH G
KAHIMTANG	K AH HH IH M T AH NG
KAHIMTANGA	K AE HH AH M T AE N G AH
KAHINUMDUMAN	K AH HH IH N AH M D Y UW M AH N
KAHIPUSAN	K AH HH IH P AH S AH N
KAHIWIAN	K AH HH IH W IY AH N
KAHON	K AE HH AH N
KAHOY	K AE HH OW IY
KAHOYAN	K AE HH OY AH N
KAHUGPONGAN	K AH HH AH G P AA N G AH N
KAHUGUT	K AE HH Y UW G AH T
KAHULOGAN	K AE HH Y UW L AH G AH N
KAHULUGAN	K AE HH Y AH L UW G AH N
KAHUMOG	K AE HH Y UW M AH G
KAIBIGAN	K EY B AH G AH N
KAIBUG	K EY B AH G
KAIGANG	K EY G AH NG
KAIGSOONAN	K EY G S UW N AH N
KAIHION	K EY IY AH N
KAILA	K EY L AH
KAILHANAN	K EY L HH AH N AH N
KAILIBGON	K EY L IH B AH N
KAINGON	K EY N G AH N
KAINIT	K EY N AH T
KAINOM	K EY N AH M
KAIPON	K EY P AH N
KAISOG	K EY S AH G
KAISTORYA	K EY S T AO R AY AH
KAISUG	K EY S AH G
KAKA	K AE K AH
KAKABOS	K AE K AH B AH Z
KAKAININ	K AH K EY N AH N
KAKALIT	K AE K AH L AH T
KAKAW	K AE K AH
KAKIAT	K EY K IY AH T
KAKITA	K AE K AH T AH
KAKLASE	K AE K L EY Z
KAKOMPETENSYA	K AH K AA M P AH T EH N S AY AH
KAKTUS	K AE K T AH S
KAKUHAG	K AE K AH HH AH G
KAKULANGAN	K AE K Y AH L AE N G AH N
KAKUSOG	K AE K Y UW S AH G
KAKUYAW	K AE K Y UW AY AH
KALAAY	K AE L AH IY
KALABASA	K AH L AE B AH S AH
KALABAW	K AE L AH B AH
KALABERA	K AH L AE B AH R AH
KALABOT	K AE L AH B AH T
KALABOTAN	K AH L AE B AH T AH N
KALAG	K AE L AH G
KALAGLAGAN	K AH L AE G L AH JH AH N
KALAGSIK	K AH L AE G S AH K
KALAIN	K AH L EY N
KALAINAN	K AH L EY N AH N
KALAKTOD	K AH L AE K T AH D
KALAMBOAN	K AH L AE M B OW AH N
KALAMBUAN	K AH L AE M B Y UW AH N
KALAMI	K AE L AH M IY
KALAMPOSAN	K AH L AE M P AH Z AH N
KALAN	K EY L AH N
KALAPASAN	K AH L AE P AH Z AH N
KALAPUKAN	K AE L AH P Y UW K AH N
KALASAG	K AE L AH S AH G
KALASANGAN	K AE L AH S AE N G AH N
KALAWASAN	K AH L AO AH Z AH N
KALAWAT	K AE L AH AH T
KALAYO	K AE L EY OW
KALBARYO	K AE L B AE R AY OW
KALBO	K AE L B OW
KALDERETA	K AE L D EH R AH T AH
KALDERO	K AE L D AH R OW
KALDIRO	K AE L D AH R OW
KALDO	K AE L D OW
KALENDARYO	K AE L AH N D AE R AY OW
KALIBANG	K AE L AH B AH NG
KALIBANGA	K AE L AH B AE N G AH
KALIBANGON	K AE L AH B AE N G AH N
KALIBO	K AE L AH B OW
KALIBOG	K AE L AH B AH G
KALIBOGAN	K AH L IH B AH G AH N
KALIBOTAN	K AH L IH B AH T AH N
KALIBOTANON	K AE L AH B AA T AH N AH N
KALIBRE	K AE L AH B AH R
KALIBUTAN	K AE L AH B Y UW T AH N
KALIDAD	K AE L AH D AH D
KALIGDONG	K AH L IH G D AH NG
KALIGO	K AE L AH G OW
KALIGUAN	K AH L IH G Y UW AH N
KALIHOKAN	K AH L IH HH AH K AH N
KALIHUKAN	K AE L AH HH Y UW K AH N
KALIKAYAN	K AH L IH K EY AH N
KALIM	K AE L AH M
KALIMAN	K AE L AH M AH N
KALIMOT	K AE L AH M AH T
KALIMUTAW	K AE L AH M Y UW T AH
KALINAW	K AE L AH N AH
KALINGAW	K AH L IH N G AH
KALINGAWAN	K EY L IH NG AH W AA N
KALIPAY	K AH L IH P EY IY
KALIS	K AE L IH S
KALISANG	K AE L AH S AH NG
KALISDANAN	K AH L IH Z D AH N AH N
KALISOD	K AE L AH S AH D
KALISUD	K AE L AH S AH D
KALIT	K AE L AH T
KALIWATAN	K AE L AH W EY T AH N
KALKULO	K AE L K Y UW L OW
KALMALANG	K AE L M AH L AH NG
KALO	K EY L OW
KALORIYA	K AE L AH R IY AY AH
KALOTA	K AE L AH T AH
KALSADA	K AE L S AH D AH
KALSYO	K AE L S AY OW
KALUHA	K AE L AH HH AH
KALUNGSORAN	K AH L AH N G S AH R AH N
KALUOY	K AH L UW W OW IY
KALUSOT	K AH L UW S AH T
KALUWASAN	K AH L AH W AH Z AH N
KALUY	K AH L UW W IY
KALYE	K AE L AY
KAMA	K AA M AH
KAMADA	K AE M AH D AH
KAMAGAYAN	K AH M AE G EY AH N
KAMAGULANGAN	K AH M AE G Y AH L AE N G AH N
KAMAGWANGAN	K AH M AE G W AA N G AH N
KAMAHAL	K AE M AH AH L
KAMAHINUNGDANON	K AE M AH HH AH N AH N G D AH N AH N
KAMANDOAN	K AH M AE N D OW AH N
KAMANDUAN	K AH M AE N D Y UW AH N
KAMANGHORAN	K AH M AE N AH R AH N
KAMANGHURAN	K AH M AE N Y AH R AH N
KAMAO	K AE M EY OW
KAMAPANILYA	K AE M AH P AH N IH L AY AH
KAMAROTE	K AE M AH R OW T
KAMASUSO	K AE M AH S UW S OW
KAMATAYON	K AH M AE T EY AH N
KAMATAYONG	K AH M AE T EY AH NG
KAMATIS	K EY M EY T AH S
KAMAY	K AE M EY IY
KAMELYA	K AH M EH L AY AH
KAMELYO	K AH M EH L AY OW
KAMI	K AE M IY
KAMILYO	K AH M IH L AY OW
KAMINGAWAN	K AH M IH N G AH AH N
KAMINYOON	K AH M IH N AY UW N
KAMISA	K AE M AH S AH
KAMISETA	K AH M IH S AH T AH
KAMISIN	K AE M AH S AH N
KAMISON	K AE M AH S AH N
KAMIY	K AE M AY IY
KAMO	K AE M OW
KAMOG	K AE M AH G
KAMONG	K AE M AH NG
KAMOT	K AE M AH T
KAMOTENG	K AE M AH T AH NG
KAMOTIHAN	K AH M AA T AH AH N
KAMOY	K AE M OW IY
KAMPANA	K AE M P AH N AH
KAMPANARYO	K AE M P AH N AE R AY OW
KAMPANERO	K AE M P AE N AH R OW
KAMPANYA	K AE M P AE N AY AH
KAMPEYON	K AE M P EY AH N
KAMPIYON	K AE M P IY AY AH N
KAMPO	K AE M P OW
KAMPOR	K AE M P AH R
KAMPYON	K AE M P AY AH N
KAMUGAW	K AE M Y UW G AH
KAMULO	K AE M Y UW L OW
KAMUNGGAY	K AH M AH N G EY IY
KAMUT	K AE M AH T
KAN	K AE N
KANA	K AE N AH
KANAKO	K AE N AH K OW
KANAMO	K AE N AH M OW
KANANAN	K AE N AH N AH N
KANANG	K AE N AH NG
KANARYO	K AH N AE R AY OW
KANASUDNON	K AE N AH S AH D N AH N
KANAUG	K AE N AH G
KANDADO	K AE N D AH D OW
KANDELABRO	K AE N D AH L AE B R OW
KANDELERO	K AE N D EH L AH R OW
KANDIDATO	K AE N D IH D AH T OW
KANDIIS	K AE N D IY AH S
KANDIISON	K AE N D IY S AH N
KANDILA	K AE N D AH L AH
KANDING	K AE N D AH NG
KANG	K AE NG
KANG(2)	K AA NG
KANGILO	K AE N JH AH L OW
KANGITNGIT	K AE N JH IH T N JH AH T
KANHI	K AE N HH IY
KANIADTO	K EY N IY AE D T OW
KANIADTONG	K EY N IY AE D T AH NG
KANIATO	K EY N IY AH T OW
KANILA	K AE N AH L AH
KANIMO	K AE N AH M OW
KANINYO	K AH N IH N AY OW
KANINYONG	K AH N IH N AY AH NG
KANIYA	K EY N IY AY AH
KANIYANG	K EY N IY AY AH NG
KANO	K AA N OW
KANSANG	K AE N S AH NG
KANSELA	K AE N S AH L AH
KANSER	K AE N Z AH R
KANSERON	K AE N S AH R AH N
KANTA	K AE N T AH
KANTIDAD	K AE N T AH D AH D
KANTIL	K AE N T AH L
KANTINA	K AE N T AH N AH
KANTO	K AE N T OW
KANTYAW	K AE N T AY AH
KANUMAN	K AE N Y UW M AH N
KANUNAY	K AE N Y UW N EY IY
KANUNAYNG	K AE N Y AH N EY NG
KANUS	K EY N AH S
KANUSA	K AE N Y UW S AH
KANUSAKA	K AE N Y UW S AH K AH
KANYA	K AE N AY AH
KANYAMASO	K AE N AY AE M AH S OW
KANYANG	K AE N AY AH NG
KAON	K EY AH N
KAP	K AE P
KAPABILIDAD	K AE P AH B IH L AH D AH D
KAPAG	K AE P AH G
KAPAHULAYAN	K AE P AH HH Y UW L EY AH N
KAPAIT	K AH P EY T
KAPAITON	K AH P EY T AH N
KAPAKYASAN	K AE P AH K AY AH Z AH N
KAPALARAN	K AH P AE L AH R AH N
KAPANAHONAN	K AE P AH N AE HH AH N AH N
KAPANGANURAN	K AH P AE N G AE N Y AH R AH N
KAPANGASAWA	K AE P AH N G AE S AH AH
KAPANGHIMATUURAN	K AH P AE N AH M AE T Y UW Y AH R AH N
KAPARANG	K AE P AH R AH NG
KAPAREHA	K AH P AE R AH HH AH
KAPARIS	K AE P AH R AH S
KAPARYENTEHAN	K AE P AH R AY EH N T AH AH N
KAPASAD	K AE P AH S AH D
KAPASIDAD	K AH P AE S AH D AH D
KAPATAGAN	K EY P AH T AH JH AH N
KAPATAN	K EY P EY T AH N
KAPATAS	K AE P AH T AH Z
KAPAYAS	K AE P EY AH Z
KAPE	K EY P
KAPETERA	K AH P EH T AH R AH
KAPETERIYA	K AE P AH T AH R IY AY AH
KAPI	K AE P IY
KAPIHON	K AE P AH HH AH N
KAPILA	K AE P AH L AH
KAPILDIHAN	K AH P IH L D AH AH N
KAPILIAN	K EY P IH L IY AH N
KAPIN	K AE P AH N
KAPINA	K AE P AH N AH
KAPITAL	K AE P AH T AH L
KAPITALISTA	K AE P AH T AH L IH S T AH
KAPITAN	K AE P IH T AH N
KAPITOAN	K AH P IH T OW AH N
KAPITOLYO	K AE P AH T AA L AY OW
KAPITUAN	K AH P IH T Y UW AH N
KAPITULO	K AE P AH T Y UW L OW
KAPKAPAN	K AE P AH P AH N
KAPOLISAN	K AH P AA L AH S AH N
KAPOT	K AE P AH T
KAPOY	K AE P OW IY
KAPOYAN	K AE P OY AH N
KAPRITSO	K AE P R IH T S OW
KAPULIKI	K AE P Y UW L AH K IY
KAPULISAN	K AE P Y UH L AH S AH N
KAPULOAN	K AE P Y UW L OW AH N
KAPUNAWPUNAWAN	K AE P Y UW N AH P Y UW N AH AH N
KAPUNGOT	K AH P AH N G AH T
KAPUNIT	K AE P Y UW N AH T
KAPUSLANAN	K AH P AH Z L AH N AH N
KAPUY	K AE P Y UW IY
KAPUYO	K AE P Y UW AY OW
KAPUYON	K AE P Y UW AY AH N
KAPYO	K AE P AY OW
KARAAN	K AE R EY AH N
KARAGARAN	K AH R AE G AH R AH N
KARANASAN	K AH R AE N AH Z AH N
KARAT	K EH R AH T
KARATOLA	K AH R AE T AH L AH
KARBON	K AA R B AH N
KARD	K AA R D
KARE	K AE R
KARENDERIYA	K AH R EH N D AH R IY AY AH
KARERA	K AE R AH R AH
KARETON	K AE R AH T AH N
KARGA	K AA R G AH
KARGADOR	K AA R G AH D AH R
KARIRA	K AE R AH R AH
KARIYUT	K AH R IY AY AH T
KARLINGGA	K AA R L IH N G AH
KARNE	K AA R N
KARNEHA	K AA R N AH HH AH
KARNEHAN	K AA R N AH AH N
KARNENG	K AA R N AH NG
KARNERO	K AA R N AH R OW
KARON	K EH R AH N
KARONG	K AE R AH NG
KAROY	K AE R OW IY
KARPET	K AA R P AH T
KARSADA	K AA R S AH D AH
KARSADAHA	K AA R S AE D AH HH AH
KARSONES	K AA R S OW N Z
KARSONSILYO	K AA R S AH N S IH L AY OW
KARTERO	K AA R T AH R OW
KARUN	K ER UW N
KARUNG	K AE R AH NG
KAS	K AE Z
KASAB	K AE S AH B
KASABA	K AE S AH B AH
KASABOT	K AE S AH B AH T
KASABUTAN	K AE S AH B Y UW T AH N
KASADPAN	K AH S AE D P AH N
KASAG	K AE S AH G
KASAGANAAN	K AE S AH G AE N EY AH N
KASAGARAN	K AH S AE G AH R AH N
KASAGINGAN	K AE S AH JH IH N G AH N
KASAKIT	K AE S AH K AH T
KASAL	K EY S AH L
KASALIGAN	K AH S AE L AH G AH N
KASAMOK	K AE S AH M AH K
KASAMTANG	K AH S AE M T AH NG
KASAMTANGAN	K AH S AE M T AE N G AH N
KASANAG	K AE S AH N AH G
KASANGKAPAN	K AH S AE N G K AH P AH N
KASANIHAN	K AH S AE N AH AH N
KASARANGAN	K AE S AH R AE N G AH N
KASARING	K AE S AH R AH NG
KASAULOGAN	K AH S AO L AH G AH N
KASAYON	K AE S EY AH N
KASAYSAYAN	K AH S EY S EY AH N
KASAYURAN	K AH S EY Y AH R AH N
KASI	K AA Z IY
KASIGUROHAN	K AH S IH G Y UH R AH AH N
KASIGURUAN	K AH S IH G Y AH R UW W AH N
KASIKAS	K AE S AH K AH Z
KASIKBIT	K AH S IH K B AH T
KASILAK	K AE S AH L AH K
KASILI	K AE S AH L IY
KASILINGANAN	K AE S AH L IH N G AH N AH N
KASILYAS	K AH S IH L AY AH Z
KASINATIAN	K AE S AH N EY SH AH N
KASING	K EY Z AH NG
KASINGKASING	K AE S AH N G K EY Z AH NG
KASIRAHAN	K AH S IH R AH AH N
KASIYAHAN	K EY S IY AY AH AH N
KASIYAMAN	K EY S IY AY AH M AH N
KASIYARNAN	K EY S IY AY AA R N AH N
KASKARO	K AE S AH R OW
KASKO	K AE S OW
KASLON	K AE Z L AH N
KASLONON	K AE Z L AH N AH N
KASO	K AE S OW
KASONG	K AE S AH NG
KASOSYO	K AH S AA S AY OW
KASOY	K AE S OW IY
KASUB	K AE S AH B
KASUBO	K AH S UW B OW
KASUDLAN	K AH S AH D L AH N
KASUGIRAN	K AH S UW JH AH R AH N
KASUGUAN	K AH S UW G Y UW AH N
KASUHAN	K AE S AH AH N
KASUKAON	K AH S UW K EY AH N
KASUKO	K AH S UW K OW
KASUKOD	K AH S UW K AH D
KASULATAN	K AE ZH AH L EY T AH N
KASULBARAN	K AH S AH L B AH R AH N
KASUNDALOHAN	K AH S AH N D AE L AH AH N
KASUNDALUHAN	K AH S AH N D AE L AH AH N
KASUOD	K AH S UW W AH D
KAT	K AE T
KATAAS	K AE T AH Z
KATABANG	K AE T AH B AH NG
KATAGILUNGSOD	K AE T AH JH AH L AH N G S AH D
KATAHIMIKAN	K AE T AH HH IH M AH K AH N
KATAHOM	K AE T AH HH AH M
KATAKUS	K AE T AH K AH S
KATALAGMAN	K AH T AE L AH M AH N
KATAM	K AE T AH M
KATANGIANG	K AH T AE N JH IY AH NG
KATAPUSAN	K AH T AE P AH S AH N
KATAPUSANG	K AE T AH P Y UW S AH NG
KATARONG	K AE T AH R AH NG
KATARUNG	K AE T AH R AH NG
KATAW	K AE T AH
KATAWA	K AE T AH AH
KATAWHAN	K AE T AH AH N
KATAWOHON	K AH T AO AH HH AH N
KATEGORYA	K AE T AH G AO R AY AH
KATIGULANGAN	K AH T IH G Y AH L AE N G AH N
KATIGUMAN	K AE T AH G Y UW M AH N
KATINGALAHAN	K AH T IH N G AE L AH AH N
KATITIKAN	K AH T IH T AH K AH N
KATITIKANG	K AH T IH T AH K AH NG
KATLOAN	K AE T L OW AH N
KATOL	K AE T AH L
KATOLIKO	K AH T AA L AH K OW
KATRE	K EY T AH R
KATSILAON	K AE T S IH L EY AH N
KATUBIGAN	K AE T Y UW B AH G AH N
KATUBUYAN	K AE T Y UW B Y UW AY AH N
KATUGNAW	K AH T AH G N AH
KATUGON	K AE T Y UW G AH N
KATUIGAN	K AH T UW G AH N
KATULGON	K AH T AH L G AH N
KATULIKO	K AE T Y UW L AH K OW
KATULO	K AE T Y UW L OW
KATULOG	K AE T Y UW L AH G
KATULOGON	K AE T Y UW L AH G AH N
KATUNGA	K AH T AH N G AH
KATUNGDANAN	K AH T AH N G D AH N AH N
KATUNHAYAN	K AH T AH N HH EY AH N
KATUNOG	K AE T Y UW N AH G
KATUOHAN	K AE T Y UW AH AH N
KATUUHAN	K AE T Y UW AH AH N
KATUYOAN	K AE T Y UW AY OW AH N
KAUBAN	K AO B AH N
KAUBANAN	K AO B AH N AH N
KAUBANG	K AO B AH NG
KAUDTOHON	K AO D T AH HH AH N
KAUGALINGON	K AO G AH L IH N G AH N
KAUGALINGONG	K AO G AH L IH N G AH NG
KAUGMAON	K AO G M EY AH N
KAULAW	K AO L AH
KAUNON	K AO N AH N
KAUNURAN	K AO N Y AH R AH N
KAUPAW	K AO P AH
KAUSA	K AO S AH
KAUSABAN	K AO S AH B AH N
KAUSBAWAN	K AO Z AH AH N
KAWA	K AA W AH
KAWAD	K AO AH D
KAWALI	K AO AH L IY
KAWALWAN	K AO AE L W AH N
KAWANANGAN	K AO AH N AE N G AH N
KAWANG	K AO AH NG
KAWANI	K AO AH N IY
KAWATAN	K AO EY T AH N
KAWAYAN	K AO EY AH N
KAWHAAN	K AO HH EY AH N
KAWIT	K AO AH T
KAWITANAN	K AO IH T AH N AH N
KAWKAW	K AO K AH
KAWLOHAN	K AO L AH AH N
KAWOTA	K AO AH T AH
KAY	K EY
KAYDA	K EY D AH
KAYLAP	K EY L AH P
KAYMITO	K EY M AH T OW
KAYO	K EY OW
KAYONG	K EY AH NG
KAYSA	K EY S AH
KEMIKAL	K EH M AH K AH L
KENDI	K EH N D IY
KENNEN	K EH N AH N
KERIDA	K EH R AH D AH
KESEYO	K IY S EY OW
KESO	K EH S OW
KIAT	K AY AH T
KIATON	K AY AH T AH N
KIBUT	K IH B AH T
KIDNAP	K IH D N AE P
KIDNAPING	K IH D N AE P IH NG
KIDNAPON	K IH D N AE P AO N
KIDNEY	K IH D N IY
KIDNI	K IH D N IY
KIGHANOT	K AY AH N AH T
KIGHIGALA	K AY IH G AH L AH
KIGTRATO	K IH G T R AH T OW
KIHA	K IH HH AH
KIKI	K IY K IY
KILAT	K IH L AH T
KILAWON	K IH L AH AH N
KILAWUNUN	K IH L AH UW N AH N
KILAY	K IH L EY IY
KILID	K IH L AH D
KILIKILI	K AH L IH K AH L IY
KILINO	K IH L AH N OW
KILIRAN	K IH L AH R AH N
KILO	K IH L OW
KILOMKILOM	K AH L AA M K AH L AH M
KILONG	K IH L AH NG
KILUMKILOM	K AH L AH M K AH L AH M
KILUMKILUM	K AH L AH M K AH L AH M
KIM	K IH M
KIMPANG	K IH M P AH NG
KINAADMAN	K AH N AA D M AH N
KINABUHI	K AH N AE B AH HH IY
KINABUHING	K AH N AE B AH AH NG
KINAHAM	K IH N AH HH AE M
KINAHANGLAN	K IH N AH HH AE N G L AH N
KINAHANGLANG	K IH N AH HH AE N G L AH NG
KINAHANGLANON	K IH N AH HH AE N G L AH N AH N
KINAHANLAN	K IH N AH HH AE N L AH N
KINAIYA	K AH N EY AY AH
KINAIYAHAN	K AH N EY AY AH AH N
KINAIYANG	K AH N EY AY AH NG
KINAPINTASAN	K IH N AH P IH N T AH Z AH N
KINARAAN	K AH N AE R EY AH N
KINASINGKASING	K AH N AE S AH N G K EY Z AH NG
KINATIBUK	K AH N AE T AH B AH K
KINATUMYAN	K IH N AH T Y UW M AY AH N
KINHASON	K IH N HH AH S AH N
KINI	K IH N IY
KINIENTOS	K IH N IY AH N T AA S
KINILAW	K IH N AH L AH
KINING	K IH N IH NG
KINITAAN	K AH N IH T EY AH N
KINSA	K IH N S AH
KINSANG	K IH N S AE NG
KINSAY	K IH N S EY
KINSE	K IH N S
KINSENA	K IH N S AH N AH
KINUGOS	K IH N Y UW G AH Z
KINUTUBAN	K IH N Y UW T Y UW B AH N
KIRIWAN	K IH R AH W AH N
KISAME	K AH S EY M
KISAMI	K IH S AH M IY
KISKISI	K IH S AH S IY
KIT	K IH T
KITA	K IY T AH
KITANG	K IH T AH NG
KITAON	K IH T AH AO N
KITAY	K IH T EY IY
KITONG	K IH T AH NG
KIWISKIWIS	K AH W IH S AH W AH S
KLARO	K L AE R OW
KLASE	K L EY Z
KLASEHANAN	K L AH S EH HH AH N AH N
KLASIKO	K L AE S AH K OW
KLASIKONG	K L AE S AH K AH NG
KLIMA	K L AY M AH
KLINIKA	K L IH N AH K AH
KLIYENTE	K L AY AY AH N T
KM	K EY M
KO	K OW
KOALISYON	K OW L IH S AY AH N
KODAK	K OW D AE K
KODIGO	K AA D AH G OW
KOG	K AA G
KOGON	K AA G AH N
KOLEHIYO	K AA L AH HH IY AY OW
KOLEKSYON	K AH L EH K S AY AH N
KOLEKTIBO	K AH L EH K T AH B OW
KOLESTEROL	K AH L EH S T AH R AH L
KOLONYA	K AH L AA N AY AH
KOLONYAL	K AH L AA N AY AH L
KOLOR	K OW L AH R
KOLORI	K AA L AH R IY
KOLUM	K AA L AH M
KOLUMNISTA	K AA L AH M N IH S T AH
KOMANDER	K AH M AE N D AH R
KOMBATE	K AA M B EY T
KOMBENSIYON	K AA M B AH N S IY AY AH N
KOMBIKSYON	K AA M B IH K S AY AH N
KOMBINASYON	K AA M B AH N AE S AY AH N
KOMBINSIHON	K AA M B IH N S AH HH AH N
KOMEDOR	K AA M AH D AH R
KOMEDYA	K AH M EH D AY AH
KOMEDYAHAN	K AA M AH D AY AH AH N
KOMEDYANTE	K AH M EH D AY AH N T
KOMENTARISTA	K AH M EH N T AH R IH S T AH
KOMENTARYO	K AA M AH N T AE R AY OW
KOMERSYAL	K AH M AH R S AY AH L
KOMITE	K AH M AY T
KOMON	K AA M AH N
KOMPANYA	K AA M P AE N AY AH
KOMPAS	K AA M P AH Z
KOMPERENSYA	K AA M P AH R EH N S AY AH
KOMPETISYON	K AA M P AH T IH S AY AH N
KOMPLETO	K AA M P L AH T OW
KOMPLIKADO	K AA M P L IH K AH D OW
KOMPORTABLE	K AA M P AO R T AH B AH L
KOMPOSISYON	K AA M P AH S IH S AY AH N
KOMPREHENSIBO	K AA M P R AH HH EH N S AH B OW
KOMPRONTA	K AA M P R AA N T AH
KOMPRONTASYON	K AA M P R AH N T AE S AY AH N
KOMPYUTER	K AA M P AH Y UW T AH R
KOMUN	K AA M AH N
KOMUNIDAD	K AA M Y UW N AH D AH D
KOMUNIKASYON	K AA M Y UW N AH K AE S AY AH N
KON	K AA N
KONDE	K AA N D
KONDISYON	K AA N D IH S AY AH N
KONDOKTOR	K AA N D AA K T AH R
KONDOL	K AA N D AH L
KONDOM	K AA N
KONDUKTOR	K AA N D AH K T AH R
KONEHO	K AA N AH HH OW
KONEKSYON	K AH N EH K S AY AH N
KONEKTAR	K AH N EH K T AH R
KONG	K AO NG
KONG(2)	K AO NG G
KONGKRETO	K AA N G K R AH T OW
KONGRESISTA	K AA N G R AH S IH S T AH
KONGRESO	K AA N G R AH S OW
KONGRISISTA	K AA N G R AH S IH S T AH
KONKLUSYON	K AO NG K L UW S AY AH N
KONOY	K AA N OW IY
KONSEHAL	K AA N S AH AH L
KONSEHO	K AA N S AH HH OW
KONSENSYA	K AA N S EH N S AY AH
KONSENTRASYON	K AA N S AH N T R AE S AY AH N
KONSEPTO	K AA N S EH P T OW
KONSERBATIBO	K AA N S AH R B AE T AH B OW
KONSIDERASYON	K AA N S AH D AH R AE S AY AH N
KONSONANTE	K AA N S AH N AH N T
KONSTITUSYONAL	K AA N S T IH T Y AH S AY AH N AH L
KONSTRAKSYON	K AA N S T R AE K S AY AH N
KONSULTA	K AA N S AH L T AH
KONSUMIDOR	K AA N S UW M AH D AH R
KONSUMO	K AA N S UW M OW
KONSYERTO	K AA N S AY AH R T OW
KONTAK	K AA N T AH K
KONTAKON	K AA N T AH K AH N
KONTEKSTO	K AA N T EH K S T OW
KONTINENTE	K AA N T AH N AH N T
KONTRA	K AA N T R AH
KONTRATA	K AA N T R AH T AH
KONTRIBUSYON	K AA N T R AH B Y UW S AY AH N
KONTROBERSIYA	K AA N T R AH B AH R S IY AY AH
KONTROBERSYAL	K AA N T R AH B AH R S AY AH L
KONTROL	K AA N T R AH L
KOOPERASYON	K UW P AH R AE S AY AH N
KOPA	K OW P AH
KOPYA	K AA P AY AH
KORAL	K AO R AH L
KORD	K AO R D
KOREK	K AO R AH K
KORI	K AO R IY
KORMATAHAN	K AO R M AE T AH AH N
KORONA	K ER OW N AH
KORPORASYON	K AO R P AH R AE S AY AH N
KORTA	K AO R T AH
KORTE	K AO R T
KOSINA	K AA S AH N AH
KOY	K OW IY
KREDITO	K R EH D AH T OW
KREMA	K R EH M AH
KRIM	K R IH M
KRIMEN	K R AY M AH N
KRIMIN	K R IH M AH N
KRIMINAL	K R IH M AH N AH L
KRISIS	K R IH S AH S
KRISTIYANO	K R IH S T IY AY AH N OW
KRITIKAL	K R IH T AH K AH L
KRITIKO	K R IH T AH K OW
KRUDO	K R UW D OW
KRUS	K R AH S
KRUSIPIHO	K R UW S IH P AH HH OW
KTSK	K EY T IY EH S K
KUBREKANLA	K AH B R AH K AE N L AH
KUBUS	K Y UW B AH S
KUDKOD	K AH D K AH D
KUGI	K Y UW JH IY
KUGIHAN	K Y UW JH AH AH N
KUGITA	K Y UW JH AH T AH
KUGOS	K Y UW G AH Z
KUHA	K AH HH AH
KUHAA	K AH HH AH
KUHAAN	K AH HH EY AH N
KUHAI	K AH HH EY
KUHAON	K AH HH EY AH N
KUKO	K Y UW K OW
KULANG	K Y UW L AH NG
KULATA	K Y UW L AH T AH
KULBA	K AH L B AH
KULBAHINAM	K AH L B AE HH AH N AH M
KULGIT	K AH L JH AH T
KULI	K Y UW L IY
KULIHOD	K Y UW L AH HH AH D
KULOB	K Y UW L AH B
KULON	K UW L AO N
KULOT	K Y UW L AH T
KULTURA	K AH L T Y AH R AH
KULUB	K Y UW L AH B
KUM	K AH M
KUMA	K Y UW M AH
KUMADRE	K Y UW M AH D AH R
KUMAGKO	K Y UW M AE G K OW
KUMAKAIN	K Y UW M AH K EY N
KUMANDER	K Y UW M AE N D AH R
KUMINGKING	K Y UW M IH N G K AH NG
KUMITA	K Y UW M AH T AH
KUMO	K Y UW M OW
KUMOT	K Y UW M AH T
KUMPADRE	K AH M P AH D AH R
KUMPIT	K AH M P AH T
KUMPLETO	K AH M P L AH T OW
KUMPOL	K AH M P AH L
KUMPRADA	K AH M P R AH D AH
KUMUSTA	K Y UW M AH S T AH
KUN	K AH N
KUNG	K AH NG
KUNGKONG	K AH N G K AH NG
KUNHOD	K AH N HH AH D
KUNO	K Y UW N OW
KUNONG	K Y UW N AH NG
KUNSINSYA	K AH N S IH N S AY AH
KUNUT	K Y UW N AH T
KUNWARING	K AH N W AH R AH NG
KUPOT	K Y UW P AH T
KUPTANAN	K AH P T AH N AH N
KUPUTAN	K Y UW P Y UW T AH N
KURAT	K Y UH R AH T
KURATA	K Y UH R AH T AH
KURIKULUM	K Y UH R AH K Y UW L AH M
KURIPOT	K Y UH R AH P AH T
KUROG	K Y UH R AH G
KURSO	K AH R S OW
KURTINA	K AH R T AH N AH
KURYENTE	K Y UH R AY AH N T
KUSGAN	K AH Z AH N
KUSINA	K Y UW S AH N AH
KUSINERA	K Y UW S IH N AH R AH
KUSINERO	K Y UW S IH N AH R OW
KUSOG	K Y UW S AH G
KUSOGA	K Y UW S AH G AH
KUSTOMER	K AH S T OW M AH R
KUSTUMBRE	K AH S T AH M B AH R
KUTAY	K Y UW T EY IY
KUTI	K Y UW T IY
KUTKUT	K AH T AH T
KUTO	K Y UW T OW
KUTOB	K Y UW T AH B
KUTOBSA	K Y UW T AA B S AH
KUTSARA	K AH T S AH R AH
KUTSILYO	K AH T S IH L AY OW
KUTSINTA	K AH T S IH N T AH
KUTSON	K AH T S AH N
KUWANG	K AH W AH NG
KUWARTA	K AH W AO R T AH
KUWARTAHAN	K AH W AO R T AH AH N
KUWARTO	K AH W AO R T OW
KUWARTOHA	K AH W AO R T AH HH AH
KUWARTONG	K AH W AO R T AH NG
KUWENTAHON	K AH W EH N T AH HH AH N
KUYA	K Y UW AY AH
KUYAMOY	K Y UW AY AE M OW IY
KUYAW	K Y UW AY AH
KUYAWAN	K Y UW AY AH AH N
KUYDAWO	K Y UW IH D AH OW
KUYOG	K Y UW AY AH G
KWADRAKAMALIG	K W AA D R AH K AE M AH L AH G
KWALIPIKASYON	K W AA L AH P AH K AE S AY AH N
KWARENTA	K W AH R EH N T AH
KWARTA	K W AO R T AH
KWARTAHAN	K W AO R T AH AH N
KWARTEL	K W AO R T AH L
KWARTO	K W AO R T OW
KWATRO	K W AA T R OW
KWEBA	K W EH B AH
KWENTA	K W EH N T AH
KWENTAS	K W EH N T AH Z
KYUGPOS	K AY AH G P AH Z
KYUT	K AY AH T
LA	L AA
LAAG	L AA G
LAAGAN	L EY AH JH AH N
LAB	L AE B
LABAD	L AE B AH D
LABAHA	L AE B AH HH AH
LABAN	L EY B AH N
LABANDERA	L AH B AE N D AH R AH
LABAW	L AE B AH
LABAY	L AE B EY
LABEL	L EY B AH L
LABHAN	L AE B AH N
LABHONON	L AE B HH AH N AH N
LABI	L AE B IY
LABINA	L AE B AH N AH
LABING	L AE B IH NG
LABORATORYO	L AE B AH R AH T AO R AY OW
LABORTE	L AE B AH R T
LABOT	L AE B AH T
LABTIK	L AE B T AH K
LABUD	L AE B AH D
LABUT	L AE B AH T
LACTAO	L AE K T EY OW
LADLAD	L AE D L AE D
LAG	L AE G
LAGAAK	L AE G AH K
LAGAAN	L AE G EY AH N
LAGAPAK	L AE G AH P AH K
LAGAPUK	L AE G AH P AH K
LAGARAW	L AE G AH R AO
LAGAY	L AE G EY IY
LAGBAS	L AE G AH Z
LAGDA	L AE G D AH
LAGI	L AE JH IY
LAGMIT	L AE G M AH T
LAGO	L AA G OW
LAGOT	L AE G AH T
LAGPAD	L AE G P AE D
LAGPAK	L AE G P AH K
LAGSAW	L AE G S AO
LAGSIK	L AE G S AH K
LAGTANG	L AE G T AE NG
LAGUMBAY	L AH G AH M B EY IY
LAGUNA	L AH G UW N AH
LAGUS	L EY G AH S
LAGUTMON	L AH G AH T M AH N
LAGWERTA	L AE G W AH R T AH
LAHAT	L AE HH AH T
LAHI	L AE HH IY
LAIN	L EY N
LAINA	L EY N AH
LAING	L AA IH NG
LAINLAIN	L EY N L EY N
LAKAN	L EY K AH N
LAKARIN	L EY K ER IH N
LAKAS	L AE K AH Z
LAKAW	L AE K AH
LAKI	L AE K IY
LAKIN	L AE K IH N
LAKIP	L AE K AH P
LAKTOD	L AE K T AH D
LAKWATSA	L AE K W AA T S AH
LALAGYANG	L AH L AE JH AY AH NG
LALAK	L AE L AH K
LALAKE	L AH L EY K
LALAKI	L AE L AH K IY
LALAWA	L AE L AH AH
LALAWIGAN	L AH L AO AH G AH N
LAMAN	L EY M AH N
LAMANG	L AE M AH NG
LAMANO	L AE M AH N OW
LAMAS	L AA M AH Z
LAMBA	L AE M B AH
LAMESA	L AA M EY S AH
LAMI	L AE M IY
LAMIA	L EY M IY AH
LAMIAN	L EY M IY AH N
LAMIGAS	L AE M AH G AH Z
LAMISA	L AE M AH S AH
LAMOK	L AE M AH K
LAMOY	L AE M OW IY
LAMPARILYA	L AE M P AH R IH L AY AH
LAMPASO	L AE M P AH S OW
LAMUROK	L AE M Y AH R AH K
LAMUYA	L AE M Y UW AY AH
LAMYA	L AE M AY AH
LANAHAN	L AE N AH HH AE N
LANAW	L AE N AH
LANDAG	L AE N D AH G
LANDAY	L AE N D EY
LANDIGANAN	L AE N D IH G AH N AH N
LANDONG	L AE N D AH NG
LANG	L AE NG
LANGAW	L AE N G AH
LANGGA	L AE N G AH
LANGGAM	L AE N G AH M
LANGIT	L AE N JH AH T
LANGKAY	L AE N G K EY IY
LANGUB	L AE N G AH B
LANGUYANAN	L AE N G W AY AH N AH N
LANGYAW	L AE N JH AY AH
LANOG	L AE N AH G
LANOS	L AE N AH Z
LANOT	L AE N AH T
LANSANG	L AE N S AH NG
LANSONES	L AE N S OW N Z
LANSTA	L AE N S T AH
LANTAY	L AE N T EY IY
LANTSA	L AE N T S AH
LANTUGI	L AE N T Y AH JH IY
LAO	L AW
LAOAG	L EY OW G
LAPAD	L AE P AH D
LAPALAPA	L AH P AE L AH P AH
LAPIS	L AE P AH S
LAPOK	L AE P AH K
LAPOKON	L AE P AH K AH N
LARANGAN	L AH R AE N G AH N
LARAWAN	L AE R AH AH N
LARAY	L AE R EY IY
LARGA	L AA R G AH
LARGO	L AA R G OW
LARRY	L EH R IY
LASANG	L AE S AH NG
LASANGON	L AH S AE N G AH N
LASLASAN	L AE Z L AH Z AH N
LASTIKO	L AE S T AH K OW
LASWA	L AE S W AH
LATA	L AA T AH
LATAON	L AE T EY AH N
LATAY	L AE T EY IY
LATIN	L AE T AH N
LATUS	L EY T AH S
LAUYA	L AO AY AH
LAUYAHON	L AO AY AH HH AH N
LAW	L AO
LAW(2)	L AA
LAWAAN	L AO EY AH N
LAWAK	L AO AH K
LAWAS	L AO AH Z
LAWASNON	L AO AE Z N AH N
LAWGAN	L AO G AH N
LAWOD	L AO AH D
LAWOM	L AO AH M
LAWUM	L AO AH M
LAYA	L EY AH
LAYANG	L EY AH NG
LAYAT	L EY AH T
LAYLAY	L EY L EY
LAYNER	L EY N AH R
LAYO	L EY OW
LCD	EH L S IY D
LEBEL	L EH B AH L
LECHE	L EH CH
LEGAL	L IY G AH L
LEGAZPO	L AH G AE Z P OW
LEHITIMO	L AH HH IH T AH M OW
LEKSYON	L EH K S AY AH N
LEMON	L EH M AH N
LEMONADA	L AH M AA N AH D AH
LEMONSITO	L AH M AA N S AH T OW
LENDING	L EH N D IH NG
LENTE	L EH N T
LEO	L IY OW
LEON	L IY AA N
LEONA	L IY OW N AH
LEONARDO	L IY AH N AA R D OW
LESIONS	L IY ZH AH N Z
LETRATO	L EH T R AH T OW
LETSE	L EH T S
LEYT	L EY T
LIBADURA	L AH B AE D Y AH R AH
LIBAONGON	L IH B EY AA N G AH N
LIBAT	L IH B AH T
LIBERAL	L IH B ER AH L
LIBOG	L IH B AH G
LIBOGAN	L IH B AH G AH N
LIBOTLIBOT	L AH B AA T L AH B AH T
LIBRARYA	L IH B R AE R AY AH
LIBRE	L AY B AH R
LIBRO	L IH B R OW
LIBUNGAN	L AH B AH N G AH N
LIDER	L IH D ER
LIE	L AY
LIG	L IH G
LIGA	L IH G AH
LIGAN	L AY G AH N
LIGAYA	L IH G EY AH
LIGID	L IH JH AH D
LIGO	L IH G OW
LIGOY	L IH G OW IY
LIHI	L IH HH IY
LIHOK	L IH HH AH K
LIKAW	L IH K AH
LIKAY	L IH K EY IY
LIKAYAN	L IH K EY AH N
LIKE	L AY K
LIKI	L IH K IY
LIKIDO	L IH K AH D OW
LIKO	L IH K OW
LIKOD	L IH K AH D
LIKUD	L IH K AH D
LIKUD(2)	L IY K UW D
LIKURAN	L IH K Y AH R AH N
LILA	L IY L AH
LILAS	L IH L AH Z
LILI	L IH L IY
LILIK	L IH L AH K
LILO	L IH L OW
LIM	L IH M
LIMA	L AY M AH
LIMA(2)	L IY M AH
LIMANG	L IH M AH NG
LIMAS	L AY M AH Z
LIMAS(2)	L IY M AH Z
LIMBONG	L IH M B AH NG
LIMBONGAN	L IH M B AA N G AH N
LIMITADO	L IH M AH T AH D UW
LIMITASYON	L IH M AH T AE S AY AH N
LIMOS	L IH M OW Z
LIMOS(2)	L IY M OW Z
LIMOT	L IH M AH T
LIMOTAN	L IH M AH T AH N
LIMPIYO	L IH M P IY AY OW
LIMPIYOHE	L IH M P IY AY AH HH
LIMPIYOHI	L IH M P IY AY AH HH IY
LIMPYO	L IH M P AY OW
LIMPYOHI	L IH M P AY AH HH IY
LINABOG	L IH N AH B AH G
LINAKSING	L AH N AE K S AH NG
LINAPWAAN	L AH N AE P W EY AH N
LINAT	L IH N AH T
LINATA	L IH N AH T AH
LINAW	L IH N AH
LINAWAS	L IH N AH AH Z
LINDOG	L IH N D AH G
LINGA	L IH N G AH
LINGAW	L IH N G AH
LINGAWAN	L IH N G AH AH N
LINGGANAYAN	L IH N G AE N EY AH N
LINGGO	L IH N G OW
LINGIN	L IH N JH AH N
LINGINON	L IH N JH AH N AH N
LINGKIT	L IH N G K AH T
LINGKOD	L IH N G K AH D
LINGKURANAN	L IH N G K Y UH R AH N AH N
LINIHOKAN	L AH N IH HH AH K AH N
LINITOKAN	L AH N IH T AH K AH N
LINO	L IY N OW
LINOG	L IH N AH G
LINOLYO	L AH N AA L AY OW
LINTUNGANAY	L IH N T AH N G AE N EY IY
LINUGAW	L IH N Y UW G AH
LINUGIT	L IH N Y UW JH AH T
LINUNG	L IH N AH NG
LINYA	L IH N AY AH
LIOG	L AY AH G
LIPAD	L IH P AH D
LIPATA	L IH P AH T AH
LIPONG	L IH P AH NG
LISENSYA	L AH S EH N S AY AH
LISO	L IH S OW
LISOD	L IH S AH D
LISTAHAN	L IH S T AH AH N
LISTO	L IH S T OW
LISUD	L IH S AH D
LISUR	L IH S AH R
LITERAL	L IH T ER AH L
LITERATURA	L IH T AH R AE T Y AH R AH
LITI	L IH T IY
LITO	L IH T OW
LITRATISTA	L IH T R AH T IH S T AH
LITRATO	L IH T R AH T OW
LITSONG	L IH T S AO NG
LITUB	L IH T AH B
LIUG	L IY AH G
LIWAT	L IH W AH T
LIYABE	L AY IY AH B IY
LLOYD	L OY D
LOBBY	L AA B IY
LOBO	L OW B OW
LOCAL	L OW K AH L
LOG	L AO G
LOKAL	L OW K AH L
LOKASYON	L AH K AE S AY AH N
LOLA	L OW L AH
LOLO	L OW L OW
LOMULUPYO	L AA M Y AH L UW P AY OW
LONELY	L OW N L IY
LONG	L AO NG
LOOKOUT	L UH K AW T
LOOT	L UW T
LORD	L AO R D
LORNA	L AO R N AH
LOS	L OW S
LOS(2)	L AO S
LOTE	L OW T
LOTERYA	L AH T EH R AY AH
LOVE	L AH V
LTO	L T OW
LU	L UW
LUAB	L UW W AH B
LUAG	L UW W AH G
LUAS	L UW W AH Z
LUBAY	L UW B EY IY
LUBI	L UW B IY
LUBNGANAN	L AH B N G AH N AH N
LUBONG	L UW B AH NG
LUBOT	L UW B AH T
LUBUT	L UW B AH T
LUGAR	L UW G ER
LUGARA	L UW G AH R AH
LUGARAN	L AH G AH R AE N
LUGAS	L UW G AH Z
LUGAW	L UW G AH
LUGIT	L UW JH AH T
LUGITUM	L UW JH AH T AH M
LUGOD	L UW G AH D
LUGOSON	L AH G AA S AO N
LUGUSON	L UW G Y UW S AH N
LUHA	L AH HH AH
LUISA	L UW IY Z AH
LUKAT	L UW K AH T
LUKE	L UW K
LUKOT	L UW K AH T
LUKSO	L AH K S OW
LUKU	L UW K UW
LUKUAN	L UW K Y UW AH N
LULAN	L UW L AH N
LUMABAS	L UW M AH B AH Z
LUMAD	L UW M AH D
LUMALAKAD	L UW M AE L AH K AH D
LUMALANGYAW	L UW M AH L AE N JH AY AH
LUMBA	L AH M B AH
LUMBAAN	L AH M B EY AH N
LUMBIA	L AH M B IY AH
LUMBOY	L AH M B OW IY
LUMINGON	L UW M IH N G AH N
LUMLUMANAN	L AH M L UW M AH N AH N
LUMOLUPYO	L UW M AH L UW P AY OW
LUMOS	L UW M AH Z
LUMOY	L UW M OW IY
LUMPAGON	L AH M P AH G AH N
LUMPIA	L AH M P IY AH
LUMULUPYO	L UW M Y AH L UW P AY OW
LUMURA	L UW M Y AH R AH
LUNA	L UW N AH
LUNAS	L UW N AH Z
LUNES	L UW N Z
LUNG	L AH NG
LUNGAG	L AH N G AH G
LUNGIB	L AH N JH AH B
LUNGKAB	L AH N G K AH B
LUNGON	L AH NG AO N
LUNGSOD	L AH NG S AA D
LUNGSORANON	L AH N G S AO R AH N AH N
LUNHAW	L AH N HH AH
LUOD	L UW W AH D
LUORAN	L UW W AH R AH N
LUOY	L UW W OW IY
LUPA	L UW P AH
LUPAD	L UW P AH D
LUPIS	L UW P AH S
LURAT	L UH R AH T
LUSA	L UW S AH
LUSARANAN	L UW S AE R AH N AH N
LUSO	L UW S OW
LUSOK	L UW S AH K
LUSONG	L UW S AH NG
LUSPAD	L AH S AH D
LUT	L AH T
LUTAHIN	L UW T AH HH AH N
LUTALUTA	L UW T AH L UW T AH
LUTALUTAHAN	L UW T AH L UW T AH AH N
LUTAW	L UW T AH
LUTO	L UW T OW
LUTONG	L UW T AH NG
LUTUAN	L UW T Y UW AH N
LUTUON	L UW T Y UW AH N
LUUK	L UW AH K
LUWA	L AH W AH
LUWAS	L AH W AH Z
LUY	L UW W IY
LUYA	L UW W AY AH
LUYAHON	L UW W AY AH HH AH N
LUYO	L UW W AY OW
LUZON	L UW Z AA N
M	EH M
MA	M AA
MAABIABIHON	M AA B IY AE B AH HH AH N
MAABOG	M AA B AH G
MAABOT	M AA B AH T
MAABTIK	M AA B T AH K
MAADLAW	M AA D L AH
MAAGIAN	M EY AH JH AH N
MAAKSIDENTE	M AA K S AH D AH N T
MAALAM	M AA L AH M
MAALIMUOT	M AH L IH M Y UW AH T
MAAM	M AH M
MAAMPINGON	M AA M P IH N G AH N
MAANDAN	M AA N D AH N
MAANINDOT	M AH N IH N D AH T
MAANTOS	M AA N T AH Z
MAANYAG	M AA N AY AH G
MAAPIKHAN	M AA P AH K AH N
MAAPLAYAN	M AA P L EY AH N
MAAPROBAHAN	M AA P R AA B AH AH N
MAASAWA	M AA S AH AH
MAATIMAN	M AA T AH M AH N
MAAWAYON	M AA W EY AH N
MAAYO	M AA AY OW
MAAYONG	M AA AY AH NG
MAAYUNG	M AA AY AH NG
MABABAW	M AE B AH B AH
MABAGAL	M EY B EY JH AH L
MABAGANG	M AE B AH G AH NG
MABAGDOYON	M AH B AE G D OY AH N
MABAHO	M AE B AH HH OW
MABALAKA	M AH B AE L AH K AH
MABALAKON	M AH B AE L AH K AH N
MABALIKASON	M AE B AH L IH K AH S AH N
MABANGIS	M AH B AE N JH AH S
MABANIOG	M AH B EY N IY AH G
MABANTAYI	M AH B AE N T EY IY
MABASAG	M AE B AH S AH G
MABASKOG	M AH B AE S AH G
MABASULON	M AE B AH S UW L AH N
MABAW	M AE B AH
MABAWI	M AE B AH IY
MABAYAD	M AE B EY AH D
MABDUS	M AE B D AH S
MABIBILYAR	M AE B AH B IH L AY AH R
MABIGAT	M AE B AH G AH T
MABIGOT	M AE B AH G AH T
MABIHAGON	M AH B IH HH AH G AH N
MABINANTAYON	M AE B AH N AE N T EY AH N
MABINATI	M AH B IH N AH T IY
MABITBIT	M AH B IH T B AH T
MABIYAAN	M EY B IY AY EY AH N
MABUAK	M AE B Y UW AH K
MABUBUWAL	M AE B Y UW B AH W AH L
MABUDLAY	M AH B AH D L EY IY
MABUHAT	M AE B AH HH AH T
MABUHI	M AE B AH HH IY
MABULAHANG	M AE B Y UW L AH HH AH NG
MABULAHANON	M AE B Y AH L AE HH AH N AH N
MABULOKON	M AE B Y UW L AH K AH N
MABUNGAHON	M AH B AH N G AH HH AH N
MABUROS	M AE B Y AH R AH Z
MABUTANGBUTANGON	M AE B Y AH T AE N G Y AH T AE N G AH N
MABUTI	M AE B Y AH T IY
MACABAWI	M AH K AE B AH IY
MACAPAGAL	M AE K AH P EY JH AH L
MACHINES	M AH SH IY N Z
MADAG	M AE D AH G
MADAGINOTON	M AE D AH JH IH N AH T AH N
MADAGMALON	M AH D AE G M AH L AH N
MADALA	M AE D AH L AH
MADALAS	M AE D AH L AH Z
MADALI	M AE D AH L IY
MADALIAN	M AH D EY L IY AH N
MADAM	M AE D AH M
MADANI	M AE D AH N IY
MADANIHON	M AH D AE N AH HH AH N
MADAOG	M AE D EY AH G
MADARO	M AE D AH R OW
MADASIGON	M AH D AE S AH G AH N
MADAT	M AE D AH T
MADAUT	M AE D AH T
MADAUTON	M AE D AH T AH N
MADAWAT	M AE D AH AH T
MADAYGANON	M AH D EY G AH N AH N
MADILAABON	M AH D IH L AH B AH N
MADISGRASYA	M AE D AH Z R AE S AY AH
MADISIPLINA	M AE D AH S IH P L AH N AH
MADISKUBREHI	M AE D AH S AH B R AH HH IY
MADRASTA	M AE D R AE S T AH
MADRINA	M AE D R AH N AH
MADUDUKOT	M AE D Y UW D Y UW K AH T
MADUGAY	M AE D Y UW G EY IY
MADUOLAN	M AE D Y UW AH L AH N
MAESTORYAHAN	M IY S T AH R AY AH AH N
MAESTRA	M AY S T R AH
MAESTRO	M AY S T R OW
MAG	M AE G
MAGABII	M AH G EY B IY
MAGAHI	M AE G AH HH IY
MAGAMIGO	M AH G AE M AH G OW
MAGAMIT	M AE G AH M AH T
MAGAMPING	M AH G AE M P AH NG
MAGANDA	M AH G AE N D AH
MAGAPNOD	M AH G AE P N AH D
MAGASIN	M AE G AH S AH N
MAGASTO	M AH G AE S T OW
MAGAY	M AE G EY IY
MAGAYAN	M AE G EY AH N
MAGAYANA	M AH G EY AH N AH
MAGBABANGKO	M AE G AH B AE N G K OW
MAGBABASA	M AE G AE B AH S AH
MAGBADYET	M AE G AE D AY AH T
MAGBAL	M AE G AH L
MAGBALIKBALIK	M AE G AH L IH K B AH L AH K
MAGBANGGIT	M AE G AE N JH AH T
MAGBASA	M AE G AH S AH
MAGBASUL	M AE G AH S AH L
MAGBAYAD	M AE G EY AH D
MAGBILYARD	M AE G IH L AY AH R D
MAGBINISAYA	M AE G AH N IH S EY AH
MAGBIYAHIAN	M AE G IY AY AE IY AH N
MAGBOBOLA	M AE G AA B AH L AH
MAGBUBUAK	M AE G Y UW B Y UW AH K
MAGBUBUDHI	M AE G Y AH B AH D HH IY
MAGBUBUNYOG	M AE G Y UW B Y UW N AY AH G
MAGBULAD	M AE G Y UW L AH D
MAGBULAG	M AE G Y UW L AH G
MAGBUNTAG	M AE G AH N T AH G
MAGBUOT	M AE G Y UW AH T
MAGBUS	M AE G AH S
MAGDADALA	M AE G D AE D AH L AH
MAGDAHUM	M AE G D AH HH AH M
MAGDALA	M AA G D AA L AH
MAGDALI	M AE G D AH L IY
MAGDAMGO	M AE G D AE M G OW
MAGDANGGA	M AE G D AE N G AH
MAGDAOT	M AE G D EY AH T
MAGDEPENDE	M AE G D AH P AH N D
MAGDUDA	M AE G D Y UW D AH
MAGDUDULA	M AE G D Y UW D Y UW L AH
MAGDUGAY	M AE G D Y UW G EY IY
MAGDULA	M AE G D Y UW L AH
MAGDUWA	M AE G D AH W AH
MAGGAHIN	M AE G AH HH AH N
MAGGAKIT	M AE G AH K AH T
MAGGASOLINA	M AE G AH S AA L AH N AH
MAGGIKAN	M AE JH AH K AH N
MAGGITARA	M AE JH IH T AH R AH
MAGGUBOT	M AE G Y UW B AH T
MAGHAASGOT	M AE AA Z AH T
MAGHAGO	M AE AH G OW
MAGHAHARANG	M AE AE HH AH R AH NG
MAGHANTAKIAN	M AE AH N T EY K IY AH N
MAGHAPUNAN	M AE AH P Y UW N AH N
MAGHATAG	M AE AH T AH G
MAGHATOD	M AE AH T AH D
MAGHIHIGUT	M AE IH HH AH G AH T
MAGHIKAY	M AE IH K EY IY
MAGHILOM	M AE AH L AH M
MAGHINANGYOAY	M AE AH N AE N JH AY OW IY
MAGHINAYHINAY	M AE AH N AH HH IH N EY IY
MAGHISGOT	M AE IH Z AH T
MAGHISGUT	M AE IH Z AH T
MAGHIUSA	M AE IY UW S AH
MAGHUHUDNO	M AE AH HH AH D N OW
MAGHUHUKHUK	M AE AH HH AH K AH K
MAGHUHUKOM	M AE AH HH Y UW K AH M
MAGHUHUSAY	M AE AH HH Y UW S EY IY
MAGHUKAS	M AE UW K AH Z
MAGHULAT	M AE UW L AH T
MAGHUNAHUNA	M AH UW N AH HH Y UW N AH
MAGILAKON	M AH JH IH L AH K AH N
MAGILIS	M EY JH AY L IY Z
MAGISI	M AE JH AH S IY
MAGKA	M AE G K AH
MAGKAANAK	M AE G K AH N AH K
MAGKABUWAG	M AE G K AE B AH W AH G
MAGKAHIUSA	M AE G K AH HH IY UW S AH
MAGKAHUGAW	M AE G K AH HH Y UW G AH
MAGKAKAMPO	M AE G K AH K AE M P OW
MAGKALUHA	M AE G K AE L AH HH AH
MAGKANBAS	M AE G K AE N B AH Z
MAGKARAOKE	M AE G K AE R EY OW K
MAGKASALA	M AE G K AE S AH L AH
MAGKASINABOT	M AE G K AH S IH N AH B AH T
MAGKASINUMBAGAY	M AE G K AE S AH N AH M B AE G EY IY
MAGKATAKDO	M AE G K AH T AE K D OW
MAGKATULGANAN	M AE G K AH T AH L G AH N AH N
MAGKINAHANGLAN	M AE G K IH N AH HH AE N G L AH N
MAGKITA	M AE G K AH T AH
MAGKLASE	M AE G K L EY Z
MAGKONSENTRAR	M AE G K AA N S EH N T R AH R
MAGKORI	M AE G K AH R IY
MAGKUBOT	M AE G K Y UW B AH T
MAGKUHA	M AE G K AH HH AH
MAGKULANG	M AE G K Y UW L AH NG
MAGKUPOT	M AE G K Y UW P AH T
MAGLABAD	M AE G L AH B AH D
MAGLABAY	M AE G L AE B EY IY
MAGLAKAW	M AE G L AH K AH
MAGLAKAWLAKAW	M AE G L AH K AO L AH K AH
MAGLALADLAD	M AE G L AH L AE D L AH D
MAGLAMBIGIT	M AE G L AE M B AH JH AH T
MAGLANTANG	M AE G L AE N T AH NG
MAGLAYO	M AE G L EY OW
MAGLIBOG	M AE G L AH B AH G
MAGLIGO	M AE G L AH G OW
MAGLIKAY	M AE G L IH K EY IY
MAGLIMPIYO	M AE G L AH M P IY AY OW
MAGLINGAW	M AE G L IH N G AH
MAGLINGAWLINGAW	M AE G L IH N G AH L IH N G AH
MAGLINGKOD	M AE G L IH N G K AH D
MAGLINYA	M AE G L IH N AY AH
MAGLISOD	M AE G L AH S AH D
MAGLISODLISOD	M AE G L AH S AA D L AH S AH D
MAGLISUD	M AE G L AH S AH D
MAGLUOS	M AE G L UW W AH Z
MAGLUT	M AE G L AH T
MAGLUTO	M AE G L UW T OW
MAGMADAUGON	M AE G M AE D AH G AH N
MAGMAHAL	M AE G M AH AH L
MAGMAHAY	M AE G M AE HH EY IY
MAGMALAPOY	M AE G M AH L AE P OW IY
MAGMANTENEL	M AE G M AE N T AH N AH L
MAGMATNGON	M AE G M AE T N G AH N
MAGMATUTO	M AE G M AH T Y UW T OW
MAGMERYENDA	M AE G M AH R AY EH N D AH
MAGMINYO	M AE G M IH N AY OW
MAGMITING	M AE G M AY T AH NG
MAGNAOG	M AE G N EY AH G
MAGNET	M AE G N AH T
MAGNUM	M AE G N AH M
MAGORDER	M AH G AO R D AH R
MAGP	M AE G P
MAGPA	M AE G P AH
MAGPAABANG	M AE G P AH B AH NG
MAGPAABOT	M AE G P AH B AH T
MAGPAABUT	M AE G P AH B AH T
MAGPAALOT	M AE G P AH L AH T
MAGPABASA	M AE G P AE B AH S AH
MAGPABILIN	M AE G P AE B AH L AH N
MAGPABULAK	M AE G P AH B Y UW L AH K
MAGPABUTANG	M AE G P AH B Y UW T AH NG
MAGPADALA	M AE G P AE D AH L AH
MAGPADAYON	M AE G P AE D EY AH N
MAGPAHINUMDOM	M AE G P AE HH AH N AH M
MAGPAHULAY	M AE G P AH HH Y UW L EY IY
MAGPAKAMATAY	M AE G P AH K AH M AE T EY IY
MAGPAKAON	M AE G P AE K EY AH N
MAGPAKAPOY	M AE G P AH K AE P OW IY
MAGPAKASAL	M AE G P AE K AH Z AH L
MAGPAKATAWO	M AE G P AH K AE T AH OW
MAGPAKITA	M AE G P AE K AH T AH
MAGPAKYAW	M AE G P AE K AY AH
MAGPALABA	M AE G P AE L AH B AH
MAGPALISTA	M AE G P AH L IH S T AH
MAGPALIT	M AE G P AH L AH T
MAGPALITAN	M AE G P AE L AH T AH N
MAGPAPATIGAYON	M AE G P AH P AH T IH G EY AH N
MAGPAS	M AE G P AH Z
MAGPASABOT	M AE G P AE S AH B AH T
MAGPASAGAD	M AE G P AE S AH G AH D
MAGPATABANG	M AE G P AE T AH B AH NG
MAGPATAGNA	M AE G P AH T AE G N AH
MAGPATAMBAG	M AE G P AH T AE M B AH G
MAGPATUBIL	M AE G P AH T Y UW B AH L
MAGPAUBAN	M AE G P AH B AH N
MAGPET	M AE G P AH T
MAGPIYAT	M AE G P IY AY AH T
MAGPRENATAL	M AE G P R EH N AH T AH L
MAGPUASA	M AE G P Y UW AH S AH
MAGPULOS	M AE G P Y UW L AH Z
MAGPUNSISOK	M AE G P AH N S AH S AH K
MAGPUY	M AE G P Y UW IY
MAGPUYO	M AE G P Y UW AY OW
MAGSAGUP	M AE G S AH G AH P
MAGSAKAY	M AE G S AE K EY IY
MAGSALU	M AE G S AH L UW
MAGSAMOK	M AE G S AH M AH K
MAGSANGKAY	M AE G S AE N G K EY IY
MAGSAULOG	M AE G S AH L AH G
MAGSAYO	M AE G S EY OW
MAGSAYSAY	M AE G S EY S EY IY
MAGSELOS	M AE G S AH L AH Z
MAGSERADO	M AE G S EH R AH D OW
MAGSIGI	M AE G S AH JH IY
MAGSUGOD	M AE G S UW G AH D
MAGSUMBONG	M AE G S AH M B AH NG
MAGSUONG	M AE G S UW W AH NG
MAGSUSUGILANON	M AE G S UW S AH JH IH L AH N AH N
MAGSUSULAT	M AE G S AH S UW L AH T
MAGTAMBOG	M AE G T AE M B AH G
MAGTAPOK	M AE G T AH P AH K
MAGTATAGAL	M AE G T AH T EY JH AH L
MAGTATAMBAG	M AE G T AH T AE M B AH G
MAGTIAW	M AE G T IY AH
MAGTIAYON	M AE G T IY EY AH N
MAGTIAYONG	M AE G T IY EY AH NG
MAGTIGUM	M AE G T AH G AH M
MAGTIIS	M AE G T IY AH S
MAGTOTOON	M AE G T AH T UW N
MAGTRABAHO	M AE G T R AE B AH HH OW
MAGTUDLO	M AE G T AH D L OW
MAGTUNGHA	M AE G T AH N AH
MAGTUO	M AE G T Y UW OW
MAGTUTUDLO	M AE G T Y AH T AH D L OW
MAGTUYOK	M AE G T Y UW AY AH K
MAGULANG	M AE G Y UW L AH NG
MAGUNA	M AE G Y UW N AH
MAGUWANG	M AE G AH W AH NG
MAHAAMONG	M AE HH AH M AH NG
MAHABOL	M AE HH AH B AH L
MAHADLOK	M AH HH AE D L AH K
MAHAGITON	M AH HH AE JH AH T AH N
MAHAIT	M AH HH EY T
MAHAL	M AH HH AA L
MAHALON	M AE HH AH L AH N
MAHANGIN	M AH HH AE N JH AH N
MAHATAG	M AE HH AH T AH G
MAHATAGAN	M AE AH T AH JH AH N
MAHATIG	M AE HH AH T AH G
MAHAYAG	M AE HH EY AH G
MAHAYAHAY	M AH HH EY AE HH EY IY
MAHIBALUAN	M AH HH IH B AH L UW W AH N
MAHIGALAON	M AE HH AH G AE L EY AH N
MAHIGAWAS	M AH HH IH G AH AH Z
MAHIGIT	M AE HH AH JH AH T
MAHIGUGMAON	M AE HH AH G AH G M EY AH N
MAHILABAY	M AE HH AH L AE B EY IY
MAHILUM	M AE HH AH L AH M
MAHIMO	M AE HH AH M OW
MAHIMONG	M AE HH AH M AH NG
MAHIMULAG	M AE HH AH M Y UW L AH G
MAHINAY	M AH HH IH N EY IY
MAHINUNGDANON	M AE HH AH N AH N G D AH N AH N
MAHINUNGDANONG	M AE HH AH N AH N G D AH N AH NG
MAHISUGAMAK	M AE HH AH S UW G AH M AH K
MAHITABO	M AH HH IH T AH B OW
MAHITUNGOD	M AE HH AH T AH N G AH D
MAHUGAW	M AE HH Y UW G AH
MAHULOG	M AE HH Y UW L AH G
MAHUMAN	M AE HH Y UW M AH N
MAHUMUG	M AE HH Y UW M AH G
MAHUNAHUNA	M AE HH Y UW N AH HH Y UW N AH
MAHUNAHUNAON	M AE HH Y UW N AH HH Y UW N EY AH N
MAHUNAHUNA	M AE HH Y UW N AH HH Y UW N AH
MAHUROT	M AE HH Y AH R AH T
MAHUYANG	M AE HH Y UW AY AH NG
MAIGO	M EY G OW
MAIHING	M EY AH NG
MAIIMBITAHAN	M EY IH M B IH T AH AH N
MAIISIP	M EY AH S AH P
MAIL	M EY L
MAILHIN	M EY L HH AH N
MAILHING	M EY L AH NG
MAINGAY	M EY N G EY
MAINGGIT	M EY N JH AH T
MAINIT	M EY N AH T
MAINUM	M EY N AH M
MAIS	M EY S
MAISIP	M EY S AH P
MAJOR	M EY JH ER
MAKA	M AE K AH
MAKAABOT	M AE K AH B AH T
MAKAADTO	M AH K AA D T OW
MAKAAGI	M AE K AH JH IY
MAKAANGKOG	M AH K AA N G K AH G
MAKAANTOS	M AH K AA N T AH Z
MAKAAPEKTO	M AE K AH P EH K T OW
MAKAB	M AE K AH B
MAKABANTAY	M AE K AH B AE N T EY IY
MAKABUGOK	M AE K AH B Y UW G AH K
MAKABUNGAT	M AE K AH B AH N G AH T
MAKADAGHAN	M AH K AE D AH AH N
MAKADAGHANG	M AH K AE D AH AH NG
MAKADALAAN	M AE K AH D AE L EY AH N
MAKADAOT	M AH K AE D EY AH T
MAKADAWAT	M AH K AE D AH AH T
MAKADISKOBRE	M AE K AH D IH S AH B AH R
MAKADIYUT	M AE K AH D IY AY AH T
MAKADKAD	M AH K AE D K AH D
MAKADUHA	M AH K AE D AH HH AH
MAKADUNGOG	M AE K AH D AH N G AH G
MAKAESKUWELA	M AE K IY S AH W AH L AH
MAKAGINHAWA	M AE K AH JH IH N HH AH AH
MAKAHANGYO	M AE K AH HH AE N JH AY OW
MAKAHATAG	M AH K AE HH AH T AH G
MAKAHIBALO	M AE K AH HH IH B AH L OW
MAKAHIMO	M AH K AE HH AH M OW
MAKAHINUMDOM	M AH K AE HH AH N AH M
MAKAHIPUS	M AH K AE HH AH P AH S
MAKAHUMAN	M AE K AH HH Y UW M AH N
MAKAHUWAT	M AH K AE HH AH W AH T
MAKAILA	M AH K EY L AH
MAKAILAG	M AH K EY L AH G
MAKAILIS	M AH K EY AH L AH S
MAKAKALADKAD	M AE K AH K AH L AE D K AH D
MAKAKAON	M AH K AE K EY AH N
MAKAKITA	M AH K AE K AH T AH
MAKAKITAG	M AH K AE K AH T AH G
MAKAKOMENTARYO	M AH K AE K AH M AH N T AE R AY OW
MAKALAGOT	M EY K AH L AH G AA T
MAKALIHOK	M AH K AE L AH HH AH K
MAKALILISANG	M AE K AH L IH L AH S AH NG
MAKALIMOT	M AH K AE L AH M AH T
MAKALINGKAWAS	M AE K AH L IH N G K AH AH Z
MAKALULUOY	M AE K AH L AH L UW W OW IY
MAKALUTO	M AE K AH L UW T OW
MAKAMAO	M AH K AE M EY OW
MAKAMAONG	M AH K AE M EY AH NG
MAKAMATIKOD	M AE K AH M AE T AH K AH D
MAKAMUGNA	M AE K AH M AH G N AH
MAKANUNAYON	M AE K AH N Y UW N EY AH N
MAKAON	M AE K EY AH N
MAKAPADALAG	M AE K AH P AE D AH L AH G
MAKAPADASIG	M AE K AH P AE D AH S AH G
MAKAPADAYON	M AE K AH P AE D EY AH N
MAKAPAIKAG	M AE K AH P EY K AH G
MAKAPAKITAG	M AE K AH P AE K AH T AH G
MAKAPALIT	M AH K AE P AH L AH T
MAKAPILI	M AH K AE P AH L IY
MAKAPUGONG	M AE K AH P Y UW G AH NG
MAKAPUNGOT	M AE K AH P AH N G AH T
MAKARARATING	M EY K ER ER EY T IH NG
MAKASABOT	M AH K AE S AH B AH T
MAKASABUT	M AH K AE S AH B AH T
MAKASAYSAYANON	M AE K AH S AH S EY AH N AH N
MAKASUGAKOD	M AE K AH S UW G AH K AH D
MAKASUWAT	M AH K AE S AH W AH T
MAKATABANG	M AH K AE T AH B AH NG
MAKATILAW	M AH K AE T AH L AH
MAKATINGOG	M AE K AH T IH N G AH G
MAKATUNOK	M AE K AH T Y UW N AH K
MAKAUBAN	M AE K AH B AH N
MAKAUULAW	M AE K AH UW L AH
MAKAUUWAW	M AH K AO AH W AH
MAKEUP	M EY K AH P
MAKIGDULA	M AE K AH G D Y UW L AH
MAKIGHARUNG	M AH K AY AH R AH NG
MAKIGLALIS	M AH K IH G L AH L AH S
MAKIGLAMBIGIT	M AE K AH G L AE M B AH JH AH T
MAKIGSULTI	M AE K AH G S AH L T IY
MAKIKITA	M AH K IH K AH T AH
MAKINA	M AE K AH N AH
MAKIT	M AE K AH T
MAKITA	M AE K AH T AH
MAKITANG	M AE K AH T AH NG
MAKUHA	M AE K AH HH AH
MAKULIS	M AE K Y AH L AH S
MAKULONG	M AE K Y UW L AH NG
MAKUOT	M AE K Y UW AH T
MAKUSOG	M AE K Y UW S AH G
MAKUTI	M AE K Y AH T IY
MAKUWARTAHAN	M AE K AH W AO R T AH AH N
MAKUYAW	M AE K Y UW AY AH
MALABHAN	M AH L AE B AH N
MALAGMIT	M AH L AE G M AH T
MALALIM	M AH L AE L AH M
MALALUM	M AE L AE L AH M
MALAMBOD	M AH L AE M B AH D
MALANGSANG	M AH L AE N G S AH NG
MALANSANG	M AH L AE N S AH NG
MALAPOK	M AH L AE P AH K
MALATA	M AH L AE T AH
MALDITOPILYO	M AE L D IH T AH P IH L AY OW
MALIBANG	M AH L IH B AH NG
MALIGAS	M AH L IH G AH Z
MALIGO	M AH L IH G OW
MALIGON	M AH L IH G AH N
MALIMOT	M AE L AH M AA T
MALIMTAN	M AE L IH M T AE N
MALINAWON	M AE L IH N AH W AH N
MALINGAW	M AE L AH N G AO
MALIPAYON	M AH L IH P EY AH N
MALIPAYONG	M AH L IH P EY AH NG
MALIPAYUNG	M AH L IH P EY AH NG
MALISOD	M AH L IH S AH D
MALIT	M AH L IH T
MALL	M AO L
MALOLOYON	M AH L AA L OY AH N
MALTA	M AO L T AH
MALUMO	M AE L Y UW M OW
MALUMONG	M AE L Y UW M AH NG
MAMA	M AA M AH
MAMAHIMO	M AH M AE HH AH M OW
MAMALBAS	M AH M AE L B AH Z
MAMALIGYAG	M AE M AH L IH JH AY AH G
MAMALIHOG	M AH M AE L AH HH AH G
MAMALIT	M AE M AH L AH T
MAMALUKTOT	M AE M AH L AH K T AH T
MAMAMALIT	M AH M AE M AH L AH T
MAMATAY	M AH M AE T EY IY
MAMAULI	M AE M AH L IY
MAMUGNAON	M AH M AH G N EY AH N
MAMUMUNO	M AE M Y UW M Y UW N OW
MAMUWAW	M AE M AH W AH
MAN	M AE N
MANAGEMENT	M AE N AH JH M AH N T
MANAGEMENT(2)	M AE N IH JH M AH N T
MANAGSAMA	M AH N AE G S AH M AH
MANAGTIAYONG	M AE N AH G T IY EY AH NG
MANALIPOD	M AH N AE L AH P AH D
MANAMILIT	M AH N AE M AH L AH T
MANANAMBAL	M AE N AH N AE M B AH L
MANANANGAY	M AE N AH N AE N G EY IY
MANANAOG	M AH N AE N EY AH G
MANANAP	M AA N AH N AE P
MANANG	M AE N AH NG
MANAOG	M AE N EY AH G
MANAUG	M AE N AH G
MANAY	M AA N AH IY
MANDAUE	M AE N D AH
MANDO	M AE N D UW
MANEDYER	M EY N D AY ER
MANG	M AE NG
MANGAHAS	M AE N G AH HH AH Z
MANGALIGO	M AE N G AE L AH G OW
MANGANGAYAM	M AE N G AE N G EY AH M
MANGAON	M AE N G EY AH N
MANGAPILAY	M AE N G AH P IH L EY IY
MANGASAWA	M AE N G AE S AH AH
MANGATULOG	M AE N G AE T Y UW L AH G
MANGATUMBA	M AE N G AH T AH M B AH
MANGAWAT	M AE N G AH AH T
MANGAYO	M AE N G EY OW
MANGGA	M AE N G AH
MANGGAGALING	M AE N G AH G EY L AH NG
MANGGALAB	M AE N G AH L AH B
MANGHAHATOD	M AH N AE HH AH T AH D
MANGHASOL	M AE N AH S AH L
MANGHILIBIS	M AH N IH L AH B AH S
MANGHOD	M AE N AH D
MANGHULAM	M AE N Y UW L AH M
MANGIHI	M AE N JH AH HH IY
MANGITA	M AE N JH AH T AH
MANGITNGIT	M AE N JH IH T N JH AH T
MANGLAKAW	M AE N G L AH K AH
MANGUMPRA	M AE N G AH M P R AH
MANGUSOG	M AE N G Y UW S AH G
MANGUTANA	M AE N G Y UW T AH N AH
MANIGARILYO	M AE N AH G AH R IH L AY OW
MANIHAPON	M AH N IH HH AH P AH N
MANILA	M AH N IH L AH
MANIMAWOS	M AH N IH M AH AH Z
MANINAY	M AH N IH N EY IY
MANINOY	M AH N IH N OW IY
MANIWANG	M AE N AH W AH NG
MANLALABAN	M AE N L AE L AH B AH N
MANLAPAS	M AE N L AH P AH Z
MANLIHOK	M AE N L AH HH AH K
MANNA	M AE N AH
MANNI	M AE N IY
MANOK	M AE N AH K
MANONG	M AE N AH NG
MANOY	M AE N OW IY
MANSANAS	M AE N S AH N AH Z
MANTIKILYA	M AE N T AH K IH L AY AH
MANUDLAY	M AH N AH D L EY IY
MANUFACTURING	M AE N Y AH F AE K CH ER IH NG
MANUGWAY	M AH N AH G W EY IY
MANUKAD	M AE N Y UW K AH D
MANULIS	M AE N Y AH L AH S
MANUMBALING	M AE N AH M B EY L AH NG
MANUNUPI	M AE N Y UW N Y UW P IY
MANUROY	M AE N Y UH R OW IY
MAO	M AW
MAONG	M EY AH NG
MAORAG	M EY AH R AH G
MAORANG	M EY AH R AH NG
MAOWAWON	M EY OW AH AH N
MAOY	M EY OW IY
MAPA	M AE P AH
MAPAILUBON	M AE P AH L UW B AH N
MAPAINUBSANON	M AE P AH N AH B S AH N AH N
MAPAIT	M AH P EY T
MAPAKYAS	M AH P AE K AY AH Z
MAPANALIPDANON	M AE P AH N AH L IH P D AH N AH N
MAPAPAAPAW	M AH P AE P AH P AH
MAPAUBSANON	M AH P AO B S AH N AH N
MAPIUT	M EY P IY AH T
MAPUGNGAN	M AH P AH G N G AH N
MAPUGSAN	M AH P AH G Z AH N
MAPULAK	M AE P Y UW L AH K
MAPUSA	M AE P Y UW S AH
MARADJAW	M AH R AE JH AH
MARAHAN	M AE R AH AH N
MARANAN	M AE R AH N AH N
MARCEL	M AA R S EH L
MAREKOMENDAR	M AH R EH K AH M EH N D AH R
MARGIN	M AA R JH AH N
MARICAR	M EH R IH K ER
MARICEL	M AE R AH S AH L
MARILYN	M EH R AH L AH N
MARILYN(2)	M EH R AH L IH N
MARITES	M AH R AY T S
MARK	M AA R K
MARKA	M AA R K AH
MARSHAL	M AA R SH AH L
MARSO	M AA R S OW
MARTES	M AA R T S
MARTINEZ	M AA R T IY N EH Z
MARUNONG	M AH R UW N AH NG
MAS	M AA Z
MASADYA	M AH S AE D AY AH
MASAGUNSON	M AA Z AH G AH N S AH N
MASAKITAN	M AH S AE K AH T AH N
MASAKITON	M AA Z AH K IH T AO N
MASAKSIHAN	M AH S AE K S AH AH N
MASALIGON	M AH S AE L AH G AH N
MASALITA	M AH S AE L AH T AH
MASAMA	M AE S AH M AH
MASANAGON	M AA Z AH N AE G AO N
MASANTA	M AA Z AE N T AH
MASASABUNOT	M AE S AH S AH B Y UW N AH T
MASAYON	M AE S EY AH N
MASAYOP	M AE S EY AH P
MASAYRI	M AH S EY R IY
MASIKOP	M AE S AH K AH P
MASIUT	M EY S IY AH T
MASKARA	M AE S AH R AH
MASOLOBON	M AH S AA L AH B AH N
MASTERMIND	M AE S T ER M AY N D
MASULBAD	M AH S AH L B AH D
MASULUBON	M AE S AH L UW B AH N
MASUNDANON	M AH S AH N D AH N AH N
MASUSO	M AH S UW S OW
MASUWAY	M AH S AH W EY IY
MATA	M AA T AH
MATAAS	M AE T AH Z
MATABANGAN	M AE T AH B AE N G AH N
MATAG	M AE T AH G
MATAHOM	M AE T AH HH AH M
MATAHUM	M AE T AH HH AH M
MATALIGSIK	M AE T AH L IH G S AH K
MATAMBAL	M AH T AE M B AH L
MATAMIS	M AE T AH M AH S
MATANAO	M AH T AE N EY OW
MATANG	M AE T AH NG
MATAPANG	M AE T AH P AE NG
MATAPAT	M AE T AH P AE T
MATAY	M AE T EY IY
MATAYG	M AH T EY G
MATE	M EY T
MATEDIOS	M AH T IY D IY AH Z
MATEMATIKA	M AE T AH M AE T AH K AH
MATERYAL	M EY T AH R IY AH L
MATINAGDANON	M AE T AH N AE G D AH N AH N
MATINAHURON	M AE T AH N AE HH Y AH R AH N
MATINIK	M AE T AH N AH K
MATINUDANON	M AE T AH N Y UW D AH N AH N
MATINUORON	M AE T AH N Y UW AH R AH N
MATOD	M AE T AH D
MATUD	M AE T AH D
MATUDLO	M AH T AH D L OW
MATUGHONG	M AE T AH AH NG
MATUGKAD	M AH T AH G K AH D
MATULIN	M AE T Y UW L AH N
MATULOG	M AE T Y UW L AH G
MATUMAN	M AE T Y UW M AH N
MATUMBA	M AH T AH M B AH
MATUOD	M AE T Y UW AH D
MAUDTO	M AO D T OW
MAUGA	M AO G AH
MAULAW	M AO L AH
MAULAWON	M AO L AH W AH N
MAUNSA	M AO N S AH
MAURA	M AO R AH
MAUSAHAN	M AO S AH AH N
MAUT	M AO T
MAUWAWON	M AO W AH AH N
MAWALA	M AO AH L AH
MAWILI	M AO AH L IY
MAY	M EY
MAYANA	M EY AH N AH
MAYKANUNAY	M EY K AH N Y UW N EY IY
MAYO	M EY OW
MAYOK	M EY AH K
MAYOR	M EY ER
MAYORES	M EY OW R Z
MECHADO	M EH CH AH D OW
MEDIA	M IY D IY AH
MEDICAL	M EH D AH K AH L
MEDICAL(2)	M EH D IH K AH L
MEDIKAL	M EH D AH K AH L
MEDIUM	M IY D IY AH M
MEDYA	M EH D AY AH
MEDYAS	M EH D AY AH Z
MEHIKANO	M AH HH IH K AH N OW
MEINRADO	M IY N R AH D OW
MEKANISMO	M EH K AH N IH Z M OW
MELCHOR	M EH L CH ER
MELODIYA	M EH L AH D IY AY AH
MEMBER	M EH M B ER
MEMBRO	M EH M B R OW
MEMORIAL	M AH M AO R IY AH L
MENOR	M EH N ER
MENOS	M EH N AA S
MENSAHE	M EH N S AH HH
MENTRAS	M EH N T R AH Z
MENU	M EH N Y UW
MERCADO	M ER K AA D OW
MERCUM	M AH R K AH M
MERKADO	M AH R K AH D OW
MERYENDA	M EH R AY EH N D AH
METAL	M EH T AH L
METRO	M EH T R OW
METROS	M EH T R OW Z
MGA	M G AA
MI	M IY
MIABOT	M AY AH B AH T
MIAGING	M AY AH JH AH NG
MIAMBAK	M AY AE M B AH K
MIANGKAS	M AY AE N G K AH Z
MIANGKON	M AY AE N G K AH N
MIATAKE	M AY AH T EY K
MIATUBANG	M AY AH T Y UW B AH NG
MIBALIK	M IH B AH L AH K
MIBULAG	M IH B Y UW L AH G
MICHAEL	M AY K AH L
MICHELLE	M IH SH EH L
MIDAGAN	M AY D AH JH AH N
MIDALI	M IH D AH L IY
MIDANGAT	M AH D AE N G AH T
MIDDLE	M IH D AH L
MIDEKLARAR	M AH D EH K L AH R AH R
MIDILI	M IH D AH L IY
MIDIYONG	M AH D IY AY AH NG
MIDUNGGAB	M AH D AH N G AH B
MIDYA	M IH D AY AH
MIGAWAS	M IH G AH AH Z
MIGRATE	M AY G R EY T
MIGUKOD	M IH G Y UW K AH D
MIHAGTIK	M AH HH AE G T AH K
MIHANAP	M IH HH AH N AH P
MIHANGYO	M AH HH AE N JH AY OW
MIHAPIT	M IH HH AH P AH T
MIHASMAG	M AH HH AE Z M AH G
MIHATAG	M IH HH AH T AH G
MIHINAY	M AH HH IH N EY IY
MIHUNONG	M IH HH Y UW N AH NG
MIIKYAS	M IY K AY AH Z
MIINGON	M AY IH NG AO N
MIKANAOG	M AH K AE N EY AH G
MIKARAG	M IH K AH R AH G
MIKATAP	M IH K AH T AH P
MIKAWAT	M IH K AH AH T
MIKIBO	M IH K AH B OW
MIKIDHAT	M AY K AH D HH AE T
MIKIDLAP	M AY K AH D L AE P
MIKILO	M IH K AH L OW
MIKUSOG	M IH K Y UW S AH G
MIL	M IH L
MILABAY	M IH L AH B EY
MILABNI	M AH L AE B N IY
MILAGRO	M IH L AE G R OW
MILAGUBO	M IH L AH G Y UW B OW
MILAHOS	M IH L AH HH AH Z
MILAKAW	M IH L AH K AH
MILAYAT	M IH L EY AH T
MILIHOK	M IH L AH HH AH K
MILINGI	M AH L IH N JH IY
MILITAR	M IH L AH T ER
MILUKAPA	M AH L UW K AH P AH
MILYA	M IH L AY AH
MILYON	M AY L IY AO N
MINAHAL	M IH N AH AH L
MINANG	M IH N AH NG
MINDANAO	M IH N D AH N AW
MINDANAO(2)	M IH N D AH N EY OW
MINGAW	M IH N G AH
MINGAWON	M IY IH NG AH W AH N
MINGLANILLA	M IH N G L AH N IH L AH
MINGO	M IY NG G OW
MINISTRO	M IH N IY S T R OW
MINNIE	M IH N IY
MINOR	M AY N ER
MINORIYA	M IH N AH R IY AY AH
MINORS	M AY N ER Z
MINUTO	M IH N Y UW T OW
MINYO	M IH N AY OW
MIPADAYON	M AH P AE D EY AH N
MIPADULONG	M IH P AH D Y UW L AH NG
MIPAHIMULOS	M IH P AH HH AH M Y UW L AH Z
MIPAHIYUM	M IH P AH HH IY AY AH M
MIPAKONG	M IH P AH K AH NG
MIPASALIG	M AH P AE S AH L AH G
MIPASUTOY	M IH P AH S UW T OW IY
MIPATAY	M AH P AE T EY IY
MIPUNGKO	M AH P AH N G K OW
MIRAL	M AY R AH L
MISA	M IY Z AH
MISAGBAT	M AH S AE G AH T
MISAKA	M AH S AE K AH
MISAKAY	M AH S AE K EY IY
MISAMOT	M AH S AE M AH T
MISANDIG	M AH S AE N D AH G
MISANGKO	M AH S AE N G K OW
MISANGPIT	M AH S AE N G P AH T
MISIBAT	M AH S IH B AH T
MISIBUG	M AH S IH B AH G
MISIL	M AH S IH L
MISIMANG	M IH S AH M AE NG
MISINGHAG	M IH S AH N G AE G
MISMONG	M IH S M AO NG
MISUBAY	M IH S Y UW B EY IY
MISUKA	M IH S Y UW K AH
MISUNOD	M IH S AH N AA D
MISUOT	M IH S Y UW AH T
MISYON	M AY Z IY AO N
MITABOK	M IH T AH B AH K
MITAGO	M IH T AH G OW
MITAMBONG	M AH T AE M B AH NG
MITAPOS	M IH T AH P AH Z
MITAWAG	M IH T AH AH G
MITINDOG	M AH T IH N D AH G
MITING	M AY T IH NG
MITUBAG	M IH T Y UW B AH G
MITUROK	M IH T Y AH R AH K
MITUYHAD	M IH T Y UW AH HH AH D
MIUNA	M AY UW N AH
MIUYON	M AY UW W AY AH N
MIYANGO	M AY AY AE N G OW
MIYERKULES	M AY AY AH R K Y UW L Z
MMN	EH M EH M N
MO	M OW
MOABANG	M OW B AH NG
MOABOT	M OW B AH T
MOABUT	M OW B AH T
MOADTO	M OW D T OW
MOAGI	M OW JH IY
MOANGKON	M OW N G K AH N
MOANHA	M OW N HH AH
MOAPIL	M OW P AH L
MOBALHIN	M AH B AE L HH AH N
MOBALIGYA	M AA B AH L IH JH AY AH
MOBALIK	M AA B AH L AH K
MOBALOR	M AA B AH L ER
MOBANTAY	M AA B AE N T AH IY
MOBAROG	M AA B AH R AH G
MOBARUG	M AA B AH R AH G
MOBAYLO	M AH B EY L OW
MOBILE	M OW B AH L
MOBISITA	M AH B IH S AH T AH
MOBUTO	M AA B Y UW T OW
MODAGAYDAY	M AA D AH G EY D EY IY
MODAKO	M AA D AH K OW
MODAKU	M AA D AH K UW
MODAUG	M AA D AH G
MODAWAT	M AA D AH AH T
MODAYON	M AA D EY AH N
MODE	M OW D
MODELO	M OW D EH L OW
MODERNONG	M AH D AH R N AH NG
MODESISYON	M OW D Z IY Z IY AO N
MODUAW	M AA D Y UW AH
MODUNGGO	M AH D AH N G OW
MODUOL	M AA D Y UW AH L
MODUWA	M AA D AH W AH
MOEPEKTO	M OW AH P EH K T OW
MOGAWAS	M AA G AH AH Z
MOGINHAWA	M AH JH IH N HH AH AH
MOGRADWAR	M AA G R AE D W AH R
MOGUBA	M AA G Y UW B AH
MOHANGUP	M AH HH AE N G AH P
MOHATAG	M AA HH AH T AH G
MOHAUM	M AA HH AH M
MOHUNONG	M AA HH Y UW N AH NG
MOIGO	M OY G OW
MOILA	M OY L AH
MOINGON	M OY N G AH N
MOINOM	M OY N AH M
MOINUM	M OY N AH M
MOK	M AA K
MOKALAGIW	M AH K AE L AH JH AH W
MOKANAOG	M AH K AE N EY AH G
MOKANTA	M AH K AE N T AH
MOKANTIDAD	M AH K AE N T AH D AH D
MOKAON	M AA K EY AH N
MOKATAWA	M AH K AE T AH AH
MOKATAY	M AH K AE T EY IY
MOKAWHAT	M AA K AH HH AH T
MOKAWI	M AA K AH IY
MOKUHA	M AA K AH HH AH
MOKULO	M AA K Y UW L OW
MOKUMPIYANSA	M AH K AH M P IY AY AE N S AH
MOLAGAPUK	M AH L AE G AH P AH K
MOLAHOS	M AA L AH HH AH Z
MOLAKAW	M AA L AH K AH
MOLAMBO	M AH L AE M B OW
MOLAPAS	M AA L AH P AH Z
MOLARGA	M AH L AA R G AH
MOLAYAS	M AA L EY AH Z
MOLINGI	M AH L IH N JH IY
MOLO	M OW L OW
MOLUPYO	M AH L UW P AY OW
MONEY	M AH N IY
MONG	M AO NG
MONTEVERDE	M AA N T EH V EH R D IY
MONTUERTO	M AA N T Y UW EH R T OW
MOPAAK	M AA P AH K
MOPAHIGAYON	M AA P AH HH IH G EY AH N
MOPAHULAY	M AA P AH HH Y UW L EY IY
MOPAKAON	M AH P AE K EY AH N
MOPALIT	M AA P AH L IH T
MOPATAY	M AH P AE T EY IY
MOPATIGBABAW	M AA P AH T IH G AH B AH
MOPAULI	M AA P AH L IY
MOPILI	M AA P AH L IY
MOPIRMAG	M AH P AH R M AH G
MOPOSTE	M AH P OW S T
MOPUYO	M AA P Y UW AY OW
MORAG	M AO R AH G
MORCON	M AO R K AH N
MOREKLAMO	M AH R EH K L AH M OW
MORNING	M AO R N IH NG
MORRE	M AO R
MOSAKAY	M AH S AE K EY IY
MOSAKIT	M AA S AH K AH T
MOSALIG	M AA S AH L AH G
MOSAMOT	M AA S AH M AH T
MOSANG	M AA S AH NG
MOSANONG	M AA S AH N AH NG
MOSI	M OW S IY
MOSIBAT	M AA S AH B AH T
MOSUBANG	M AH S UW B AH NG
MOSUD	M AA S AH D
MOSUHOP	M AA S AH HH AH P
MOSUKOL	M AH S UW K AH L
MOSULAY	M AH S UW L EY IY
MOSULOD	M AH S UW L AH D
MOSULTI	M AH S AH L T IY
MOSUNOD	M AH S UW N AH D
MOSUWAY	M AH S AH W EY IY
MOTABAKO	M AH T AE B AH K OW
MOTABANG	M AA T AH B AH NG
MOTAMBOK	M AH T AE M B AH K
MOTAMBONG	M AH T AE M B AH NG
MOTIBO	M AA T AH B OW
MOTIKUSKOS	M AA T AH K AH S AH Z
MOTIMO	M AA T AH M OW
MOTINDOG	M AH T IH N D AH G
MOTINGOG	M AH T IH N G AH G
MOTORELA	M AH T AO R AH L AH
MOTORISTA	M AA T AH R IH S T AH
MOTORSIKLO	M AA T AH R S IH K L OW
MOTORSIKLONG	M AA T AH R S IH K L AH NG
MOTRABAHO	M AA T R AE B AH HH OW
MOTUBO	M AA T Y UW B OW
MOTUGTOG	M AH T AH G T AH G
MOTUGTUG	M AH T AH G T AH G
MOTULON	M AA T Y UW L AH N
MOTUO	M AA T Y UW OW
MOTUTOL	M AA T Y UW T AH L
MOUBAN	M AW B AH N
MOUDTO	M AW D T OW
MOUGA	M AW G AH
MOULAN	M OW AH L AH N
MOUNA	M AW N AH
MOUWAN	M AW W AH N
MOUYON	M AW AY AH N
MUADTO	M Y UW AE D T OW
MUBO	M Y UW B OW
MUBOG	M Y UW B AH G
MUBU	M Y UW B UW
MUDAYON	M Y UW D EY AH N
MUGTOK	M AH G T AH K
MUKATAWA	M Y UW K AE T AH AH
MUKHA	M AH K AH
MUKUYOG	M Y UW K Y UW AY AH G
MULABANG	M Y UW L AH B AH NG
MULAKAW	M Y UW L AH K AH
MULTO	M UH L T OW
MUNISIPYO	M Y UW N AH S IH P AY OW
MUPANAW	M Y UW P AH N AH
MURAG	M Y UH R AH G
MUSLIM	M AH Z L AH M
MUSLIM(2)	M AH Z L IH M
MUSULOD	M Y UW S UW L AH D
MUTABOK	M Y UW T AH B AH K
MUUNA	M Y UW AH N AH
MUWEBLES	M AH W AH B AH L Z
MYEMBRO	M AY EH M B R OW
MYERKULES	M AY AH R K Y UW L Z
N	EH N
NA	N AA
NAA	N AA
NAABTAN	N AA B T AH N
NAAGIAN	N EY AH JH AH N
NAAMO	N AA M OW
NAAMONG	N AA M AH NG
NAAMOY	N AA M OW IY
NAANAD	N AA N AH D
NAANDAN	N AA N D AH N
NAANGKON	N AA N G K AH N
NAAPEKTUHAN	N AH P EH K T AH AH N
NAAY	N AA IY
NABALAK	N AE B AH L AH K
NABALAKA	N AH B AE L AH K AH
NABALDA	N AH B AE L D AH
NABANGGA	N AH B AE N G AH
NABANGGAAN	N AH B AE N G EY AH N
NABATI	N AE B AH T IY
NABAYAD	N AE B EY AH D
NABUAK	N AE B Y UW AH K
NACARIO	N AH K AE R IY OW
NADAKPAN	N AH D AE K AH N
NADALA	N AE D AH L AH
NADAT	N AE D AH T
NADAWAT	N AE D AH AH T
NADESISYUNAN	N AH D AH S IH S AY UW N AH N
NADUGANGAN	N AE D Y AH G AE N G AH N
NADUGAY	N AE D Y UW G EY IY
NADUNGOG	N AH D AH N G AH G
NAG	N AE G
NAGA	N AE G AH
NAGABITBIT	N AE G AH B IH T B IH T
NAGABUHAT	N AH G AE B AH HH AH T
NAGAHINIS	N AH G AE HH AH N AH S
NAGALAKAW	N AH G AE L AH K AH
NAGALUBID	N AE G AH L UW B AH D
NAGANDOY	N AH G AE N D OW IY
NAGAPUNTING	N AE G AH P AH N T IH NG
NAGASANDIG	N AE G AH S AE N D AH G
NAGBABAG	N AE G AH B AH G
NAGBAG	N AE G B AE G
NAGBAGUOD	N AE G AE G W AH D
NAGBALIK	N AE G AH L AH K
NAGBALIUG	N AE G EY L IY AH G
NAGBANOS	N AE G B AE N AA S
NAGBANTAY	N AE G AE N T EY IY
NAGBAYBAY	N AE G B EY B EY
NAGBINABAYENG	N AE G AH N AE B EY AH NG
NAGBUTYAG	N AE G Y UW T AY AH G
NAGBUY	N AE G B AY
NAGDAGAN	N AE G D AH JH AH N
NAGDALA	N AE G D AH L AH
NAGDALI	N AE G D AH L IY
NAGDUGAY	N AE G D Y UW G EY IY
NAGDUKA	N AE G D Y UW K AH
NAGDUNGAN	N AE G D AH N G AH N
NAGDUWA	N AE G D AH W AH
NAGESKUWELA	N AE JH AH S AH W AH L AH
NAGGAMIT	N AE G AH M AH T
NAGHABWA	N AE AE B W AH
NAGHIGDA	N AE IH G D AH
NAGHIKO	N AE AH K OW
NAGHIKOG	N AE AH K AH G
NAGHILAK	N AE AH L AH K
NAGHILANAT	N AE IH L AH N AH T
NAGHIMO	N AE AH M OW
NAGHINAMHINAM	N AE AH N AE M HH AH N AH M
NAGHINIS	N AE AH N AH S
NAGHISGOT	N AE IH Z AH T
NAGHUBO	N AE UW B OW
NAGHUGOT	N AE UW G AH T
NAGHUOT	N AE UW W AH T
NAGKABAYO	N AE G K AE B EY OW
NAGKADAGHAN	N AE G K AE D AH AH N
NAGKAKUYOG	N AE G K AH K Y UW AY AH G
NAGKALAINLAING	N AE G K AH L EY N L EY AH NG
NAGKALIBANG	N AE G K AE L AH B AH NG
NAGKALINGAW	N AE G K AH L IH N G AH
NAGKANAYON	N AE G K AE N EY AH N
NAGKANGUHAL	N AE G K AE N G AH AH L
NAGKANTA	N AE G K AE N T AH
NAGKAON	N AE G K EY AH N
NAGKATIBUWAAG	N AE G K AH T IH B AH W AH G
NAGKAYO	N AE G K EY OW
NAGKINAMOT	N AE G K IH N AH M AH T
NAGKITA	N AE G K AH T AH
NAGLAIN	N AE G L EY N
NAGLAKAW	N AE G L AH K AH
NAGLAKIP	N AE G L AH K AH P
NAGLANGKOB	N AE G L AE N G K AH B
NAGLIHOK	N AE G L AH HH AH K
NAGLIKOD	N AE G L AH K AH D
NAGLINGAW	N AE G L IH N G AH
NAGLISOD	N AE G L AH S AH D
NAGLUBOG	N AE G L UW B AH G
NAGLUBOK	N AE G L UW B AH K
NAGLUNG	N AE G L AH NG
NAGLUPAD	N AE G L UW P AH D
NAGLUTO	N AE G L UW T OW
NAGMASKARA	N AE G M AE S AH R AH
NAGMATA	N AE G M AH T AH
NAGMUGNA	N AE G M AH G N AH
NAGMUGTOK	N AE G M AH G T AH K
NAGNGIYAW	N AE G N JH IY AY AH
NAGPA	N AE G P AH
NAGPABUTO	N AE G P AH B Y UW T OW
NAGPADAYON	N AE G P AE D EY AH N
NAGPAHAYAG	N AE G P AE HH EY AH G
NAGPAHIBALO	N AE G P AH HH IH B AH L OW
NAGPAILA	N AE G P EY L AH
NAGPAILANG	N AE G P EY L AH NG
NAGPAKATAWA	N AE G P AH K AE T AH AH
NAGPAKILUOY	N AE G P AH K AH L UW W OW IY
NAGPAKITA	N AE G P AE K AH T AH
NAGPANGEDARON	N AE G P AE NG D ER AO N
NAGPANLAD	N AE G P AE N L AE D
NAGPASABOT	N AE G P AE S AH B AH T
NAGPASALAMAT	N AE G P AH S AE L AH M AH T
NAGPASULABIG	N AE G P AH S UW L AH B AH G
NAGPATUDLO	N AE G P AH T AH D L OW
NAGPLANO	N AE G P L AH N OW
NAGPUKAW	N AE G P Y UW K AH
NAGPUNGASI	N AE G P AH N G AH S IY
NAGPUROL	N AE G P Y AH R AH L
NAGPUYO	N AE G P Y UW AY OW
NAGRABEHAN	N AE G R AE B AH AH N
NAGRANGGO	N AE G R AE NG G OW
NAGRIBAL	N AE G R IH B AH L
NAGSABAK	N AE G S AH B AH K
NAGSAKAY	N AE G S AE K EY IY
NAGSALIG	N AE G S AH L AH G
NAGSANINA	N AE G S AE N AH N AH
NAGSANOSANONG	N AE G S AH N AA S AH N AH NG
NAGSAULOG	N AE G S AH L AH G
NAGSENTRO	N AE G S EH N T R OW
NAGSIGE	N AE G S AY JH
NAGSILBING	N AE G Z IH L B IY IH NG
NAGSUBAY	N AE G S UW B EY IY
NAGSUBO	N AE G S UW B OW
NAGSUGO	N AE G S UW G OW
NAGSUGOD	N AE G S UW G AH D
NAGSULTI	N AE G S AH L T IY
NAGSUNUD	N AE G S UW N AH D
NAGTAKILID	N AE G T AE K AH L AH D
NAGTALIGSIK	N AE G T AH L IH G S AH K
NAGTAN	N AE G T AE N
NAGTANUM	N AE G T AH N AH M
NAGTAPAD	N AE G T AH P AH D
NAGTINAMBID	N AE G T AH N AE M B AH D
NAGTINDOG	N AE G T IH N D AO G
NAGTINGUHA	N AE G T IH N G AH HH AH
NAGTIPUN	N AE G T AH P AH N
NAGTRABAHO	N AE G T R AE B AH HH OW
NAGTUBO	N AE G T Y UW B OW
NAGTUMOD	N AE G T Y UW M AH D
NAGTUNGKO	N AE G T AH N G K OW
NAGTUO	N AE G T Y UW OW
NAGTUPI	N AE G T Y AH P IY
NAGTUPIHANAY	N AE G T Y AH P AH HH AE N EY IY
NAGTUTOK	N AE G T Y UW T AH K
NAGTUUN	N AE G T Y UW AH N
NAGTUYAROG	N AE G T Y UW AY AH R AH G
NAGUOL	N AE G W AH L
NAGUSTUHAN	N AH G AH S T AH AH N
NAHADIIN	N AE HH AH D IY N
NAHADLOK	N AH HH AE D L AH K
NAHAGBA	N AH HH AE G AH
NAHAIBABAW	N AH HH EY B AH B AH
NAHAILAWOM	N AH HH EY L AH AH M
NAHALING	N AH HH EY L AH NG
NAHIAGUMAN	N AE HH IY AH G Y UW M AH N
NAHIBALO	N AH HH IH B AH L OW
NAHIBALOAN	N AE HH AH B AE L OW AH N
NAHIBAW	N AE HH AH B AH
NAHIBAWO	N AH HH IH B AH OW
NAHIBILIN	N AH HH IH B AH L AH N
NAHIDUNGGO	N AE HH AH D AH N G OW
NAHIGAWAS	N AH HH IH G AH AH Z
NAHIHIRAPAN	N AE HH AH HH IH R AH P AH N
NAHIKUGANG	N AE HH AH K Y UW G AH NG
NAHILAK	N AE HH AH L AH K
NAHIMO	N AE HH AH M OW
NAHIMU	N AE HH AH M UW
NAHIMUTANGAN	N AH HH IH M Y AH T AE N G AH N
NAHINABI	N AH HH IH N AH B IY
NAHINGTUNGDAN	N AH HH IH N G T AH N G D AH N
NAHINUMDOM	N AE HH AH N AH M
NAHIPANGKA	N AE HH AH P AE N G K AH
NAHIPUGWAT	N AE HH AH P AH G W AH T
NAHISAGHID	N AH HH IH S AH AH D
NAHISAKA	N AH HH IH S AH K AH
NAHISUBO	N AE HH AH S UW B OW
NAHITABO	N AH HH IH T AH B OW
NAHITABOAN	N AE HH AH T AE B OW AH N
NAHIUNA	N AE HH IY UW N AH
NAHIYAD	N AH HH IY AY AH D
NAHULOG	N AE HH Y UW L AH G
NAHUMAN	N AE HH Y UW M AH N
NAHUNAHUNAAN	N AE HH Y UW N AH HH Y UW N EY AH N
NAHUNGIT	N AH HH AH N JH AH T
NAHUROT	N AE HH Y AH R AH T
NAIBOG	N EY B AH G
NAIGO	N EY G OW
NAILANG	N EY L AH NG
NAILHAN	N EY L AH N
NAKA	N AE K AH
NAKAAGI	N AE K AH JH IY
NAKAAGING	N AH K EY AH JH AH NG
NAKAANGKOG	N AH K AA N G K AH G
NAKAAT	N AE K AH T
NAKAB	N AE K AH B
NAKABANTAY	N AE K AH B AE N T EY IY
NAKABASI	N AH K AE B AH S IY
NAKABOT	N AE K AH B AH T
NAKABSAN	N AH K AE B Z AH N
NAKADAGAN	N AH K AE D AH JH AH N
NAKADAYEG	N AH K AE D EY AH G
NAKADESISYON	N AE K AH D AH S IH S AY AH N
NAKADUNGOG	N AE K AH D AH N G AH G
NAKAGUNIT	N AE K AH G Y UW N AH T
NAKAGUSTO	N AE K AH G AH S T OW
NAKAHIBAWO	N AE K AH HH IH B AH OW
NAKAHIGAYON	N AE K AH HH IH G EY AH N
NAKAILA	N AH K EY L AH
NAKAINGON	N AH K EY N G AH N
NAKAKAON	N AH K AE K EY AH N
NAKAKITA	N AH K AE K AH T AH
NAKALIMOT	N AH K AE L AH M AH T
NAKALIMTAN	N AE K AH L IH M T AH N
NAKALITAN	N AH K AE L AH T AH N
NAKAPALINGI	N AE K AH P AH L IH N JH IY
NAKAPAMINAW	N AE K AH P AE M AH N AH
NAKAPANUKAD	N AE K AH P AH N Y UW K AH D
NAKAPUSIL	N AE K AH P Y UW S AH L
NAKASABOT	N AH K AE S AH B AH T
NAKASAKSI	N AE K AH S AE K S IY
NAKASALBAR	N AE K AH S AE L B AH R
NAKASUD	N AE K AH S AH D
NAKATAPUS	N AH K AE T AH P AH S
NAKATIPIG	N AH K AE T AH P AH G
NAKATUNGANGA	N AE K AH T AH N G AE N G AH
NAKAUKAY	N AH K AO K EY IY
NAKIG	N AE K AH G
NAKIGDAMA	N AH K IH G D AH M AH
NAKIGPINUSILAY	N AH K IH G P IH N Y AH S IH L EY IY
NAKIKILALA	N AE K AH K IH L AH L AH
NAKIT	N AE K AH T
NAKITA	N AE K AH T AH
NAKITANG	N AE K AH T AH NG
NAKO	N AE K OW
NAKONG	N AE K AH NG
NAKUHA	N AE K AH HH AH
NAKUHANG	N AE K AH HH AH NG
NAKUYAPAN	N AE K Y UW AY AH P AH N
NALABYAN	N AH L AE B AY AH N
NALAMBIGIT	N AH L AE M B AH JH AH T
NALAPSAN	N AH L AE P S AH N
NALATID	N AE L AH T AH D
NALAWAYAN	N AH L AO EY AH N
NALINGAW	N AH L IH N G AH
NALINGAWNG	N AH L IH N G AH NG
NALINGIAN	N AH L IH N JH AH N
NALIPAY	N AH L IH P EY IY
NALIPONG	N AE L AH P AH NG
NALISDAN	N AH L IH Z D AH N
NALUOY	N AH L UW W OW IY
NALUPYAK	N AH L UW P AY AH K
NAMAHAYAG	N AH M AE HH EY AH G
NAMAKAK	N AE M AH K AH K
NAMAN	N EY M AH N
NAMAT	N AE M AH T
NAMATAY	N AH M AE T EY IY
NAMATIKDAN	N AE M AH T IH K D AH N
NAMATIKOD	N AH M AE T AH K AH D
NAMATUD	N AE M AH T AH D
NAMATYAN	N AH M AE T AY AH N
NAMILIT	N AE M AH L AH T
NAMILOT	N AE M AH L AH T
NAMINYO	N AH M IH N AY OW
NAMO	N AE M OW
NAMON	N AE M AH N
NAMONG	N AE M AH NG
NAMUK	N AE M AH K
NAMULONG	N AE M Y UW L AH NG
NAMUSIL	N AE M Y UW S AH L
NANABI	N AE N AH B IY
NANANGHID	N AE N AH N AH D
NANAOG	N AE N EY AH G
NANAWAG	N AE N AH AH G
NANAWAGAN	N AH N AO AH JH AH N
NANAY	N AE N EY IY
NANG	N AE NG
NANGAANGOL	N AE N G AA N G AH L
NANGAGI	N AE N G AH JH IY
NANGAGING	N AE N G AH JH AH NG
NANGAMATAY	N AE N G AH M AE T EY IY
NANGANAK	N AE N G AH N AH K
NANGAON	N AE N G EY AH N
NANGATOL	N AE N G AH T AH L
NANGATULOG	N AE N G AE T Y UW L AH G
NANGAUGDAW	N AE N G AO G D AH
NANGAYO	N AE N G EY OW
NANGHASI	N AE N AH S IY
NANGHIMAKAK	N AH N IH M AH K AH K
NANGHINAOT	N AH N IH N EY AH T
NANGIBOT	N AE N JH AH B AH T
NANGITA	N AE N JH AH T AH
NANGKA	N AE N G K AH
NANGLIGID	N AE N G L AH JH AH D
NANGUNA	N AE N G Y UW N AH
NANGUNAY	N AE N G Y UW N EY IY
NANGUTANA	N AE N G Y UW T AH N AH
NANGUTKOT	N AE N G AH T AH T
NANGYAYARI	N AE N JH AY EY AH R IY
NANGYO	N AE N JH AY OW
NANIBSIB	N AH N IH B S AH B
NANIGURO	N AH N IH G Y AH R OW
NANIID	N EY N IY D
NANIMAHONG	N AH N IH M AH HH AH NG
NANUGON	N AE N Y UW G AH N
NANUGWAY	N AH N AH G W EY IY
NANUKAD	N AE N Y UW K AH D
NANUMPA	N AH N AH M P AH
NAOG	N EY AH G
NAPAKYAS	N AH P AE K AY AH Z
NAPALGAN	N AH P AE L G AH N
NAPALIT	N AE P AH L IH T
NAPANOOD	N AE P AH N UW D
NAPULO	N AE P Y UW L OW
NAPULOG	N AE P Y UW L AH G
NAPULOGUSA	N AE P Y UW L AH G Y UW S AH
NAPUSILAN	N AE P Y UW Z AH L AH N
NAPUTOL	N AE P Y UW T AH L
NAPUTOS	N AE P Y UW T AH Z
NARING	N AE R AH NG
NARUON	N AH R UW W AH N
NASA	N AE S AH
NASAAN	N AE S EY AH N
NASABDAN	N AH S AE B D AH N
NASAKIT	N AE S AH K AH T
NASAKMIT	N AH S AE K M AH T
NASAKYAN	N AH S AE K AY AH N
NASAMARAN	N AH S AE M AH R AH N
NASAMDAN	N AH S AE M D AH N
NASANGIT	N AH S AE N JH AH T
NASAPID	N AE S AH P AH D
NASAYOD	N AE S EY AH D
NASAYOP	N AE S EY AH P
NASAYRAN	N AH S EY R AH N
NASIKOP	N AE S AH K AH P
NASODNONG	N AH S AA D N AH NG
NASUBRAHAN	N AH S AH B R AH AH N
NASUD	N AE S AH D
NASUKO	N AH S UW K OW
NASUTA	N AH S UW T AH
NATANDOG	N AH T AE N D AH G
NATARAN	N AE T AH R AH N
NATAWHAN	N AE T AH AH N
NATAWO	N AE T AH OW
NATIGAYON	N AH T IH G EY AH N
NATO	N EY T OW
NATULOG	N AE T Y UW L AH G
NATUMBA	N AH T AH M B AH
NATURAL	N AE CH ER AH L
NATURAL(2)	N AE CH R AH L
NAULINGAN	N AH L IH N G AH N
NAUNSA	N AO N S AH
NAVARRA	N AA V AA R AH
NAWAD	N AO AH D
NAWAGTANG	N AO AE G T AH NG
NAWALA	N AO AH L AH
NAWALIS	N AO AH L AH S
NAWAWALA	N AO AO AH L AH
NAWONG	N AO AH NG
NAY	N EY
NE	N IY
NE(2)	N EY
NEGLIGIBLE	N EH G L AH JH AH B AH L
NEGLIGIBLE(2)	N EH G L IH JH AH B AH L
NEGOSYANTENG	N EH G AH S AY AE N T AH NG
NEGOSYO	N AH G AA S AY OW
NEGROS	N IY G R OW Z
NERBIYOS	N AH R B IY AY AH Z
NETWORK	N EH T W ER K
NEW	N UW
NEW(2)	N Y UW
NG	EH NG
NG(2)	IH NG
NGA	N G AA
NGABIL	N G AE B AH L
NGADTO	N G AE D T OW
NGALAN	N G EY L AH N
NGANGA	N G AE N G AH
NGANHI	N G AE N HH IY
NGANO	N G AE N OW
NGANONG	N G AE N AH NG
NGARI	N G AE R IY
NGAW	N G AO
NGDAGDAG	N G D AE G D AH G
NGIL	N JH IH L
NGILAD	N JH IH L AH D
NGILIT	N JH IH L AH T
NGIPON	N JH IH P AH N
NGITNGIT	N JH IH T N JH AH T
NGUHAL	N G AH AH L
NGUNIT	N G Y UW N AH T
NHA	N HH AA
NI	N IY
NIABOT	N AY AH B AH T
NIADTO	N AY AE D T OW
NIADTONG	N AY AE D T AH NG
NIAGI	N AY AH JH IY
NIAGING	N AY AH JH AH NG
NIALIGAR	N AY AE L AH G AH R
NIANA	N AY AH N AH
NIANANG	N AY AH N AH NG
NIANGKON	N AY AE N G K AH N
NIASOY	N AY AE S OW IY
NIBALI	N IH B AH L IY
NIBALIK	N IH B AH L AH K
NIBUTO	N IH B Y UW T OW
NIBUTYAG	N IH B Y UW T AY AH G
NICOLAS	N IH K AO L AH S
NIDAGAN	N AY D AH JH AH N
NIDALA	N IH D AH L AH
NIDUMILI	N IH D Y UW M AH L IY
NIGAWAS	N IH G AH AH Z
NIGHT	N AY T
NIGNIT	N IH G N AH T
NIGRABE	N IH G R EY B
NIHAGIT	N IH HH AH JH AH T
NIHANGYO	N AH HH AE N JH AY OW
NIHILAK	N IH HH AH L AH K
NIHIMO	N IH HH AH M OW
NIHIT	N IH HH AH T
NIHUNONG	N IH HH Y UW N AH NG
NIIGO	N IY G OW
NIINGON	N IY N G AH N
NIINI	N IY N IY
NIINING	N IY N AH NG
NIKAON	N IH K EY AH N
NIKUYOG	N IH K Y UW AY AH G
NILA	N IY L AH
NILABAY	N AH L AE B EY IY
NILAGA	N IH L AH G AH
NILAHOS	N IH L AH HH AH Z
NILAKAW	N IH L AH K AH
NILANG	N IH L AH NG
NILANGKOB	N AH L AE N G K AH B
NILAPOS	N IH L AH P AH Z
NILAPWAAN	N AH L AE P W EY AH N
NILAT	N IH L AH T
NILILI	N IH L AH L IY
NIMANDO	N AH M AE N D OW
NIMO	N IH M OW
NIMOG	N IH M AH G
NIMONG	N IH M AH NG
NINA	N IY N AH
NINDOT	N IH N D AH T
NINE	N AY N
NINETEEN	N AY N T IY N
NINETY	N AY N T IY
NING	N IH NG
NINGDALA	N IH N G D AH L AH
NINGPUSIL	N IH N G P Y UW S AH L
NINGRESPONDE	N IH N G R EH S AH N D
NINGRONDA	N IH N G R AA N D AH
NINO	N IY N OW
NINO(2)	N IY N Y OW
NINYO	N IH N AY OW
NINYONG	N IH N AY AH NG
NIPADALA	N AH P AE D AH L AH
NIPADAYAG	N AH P AE D EY AH G
NIPAGAWAS	N AH P AE G AH AH Z
NIPAHIBAWO	N IH P AH HH IH B AH OW
NIPAINGON	N AH P EY N G AH N
NIPASALIG	N AH P AE S AH L AH G
NIPASANGIL	N IH P AH S AE N JH AH L
NIPIS	N IH P IY Z
NIPUSIL	N IH P Y UW S AH L
NIRESULTA	N IH R AH S AH L T AH
NISAGPA	N AH S AE G P AH
NISIBAT	N IH S AH B AH T
NISIRIT	N IH S AH R AH T
NISUROY	N AH S UH R OW IY
NITABANG	N IH T AH B AH NG
NITAHAN	N IH T AH AH N
NITUBAG	N IH T Y UW B AH G
NITUBO	N IH T Y UW B OW
NITUMAW	N IH T Y UW M AH
NIULI	N AY AH L IY
NIUNGOT	N AY AH N G AH T
NIWANG	N IH W AH NG
NIYA	N AY AY AH
NIYANG	N AY AY AH NG
NMMC	EH N EH M EH M K
NO	N OW
NOBYEMBRE	N AA B AY EH M B AH R
NOEL	N OW EH L
NOON	N UW N
NOONG	N UW NG
NORAYA	N AO R EY AH
NORTE	N AO R T
NORTH	N AO R TH
NORTHERN	N AO R DH ER N
NOUN	N AW N
NOY	N OW IY
NUBYEMBRE	N Y UW B AY EH M B AH R
NUEBE	N Y UW AH B
NUMBER	N AH M B ER
NUMERO	N Y UW M AH R OW
NUNUT	N Y UW N AH T
NURSE	N ER S
NWEBE	N W IY B
NYANG	N AY AH NG
NYEBE	N AY IY B
NYO	N AY OW
O	OW
OATH	OW TH
OB	AA B
OBAN	OW B AH N
OBATAY	AH B AE T EY IY
OBISPO	OW B IH S P OW
OBRA	AA B R AH
OCAMPO	OW K AE M P OW
OD	AA D
OFFER	AO F ER
OFFICE	AO F AH S
OFFICER	AO F AH S ER
OFFICER(2)	AO F IH S ER
OFFICIAL	AH F IH SH AH L
OG	AA G
OK	OW K EY
OKEY	OW K IY
OKTUBRE	AA K T Y UW B AH R
OL	AA L
OM	AA M
ON	AA N
ON(2)	AO N
ONA	AH N AA
ONAN	OW N AH N
ONANG	AA N AH NG
ONE	W AH N
ONE(2)	HH W AH N
ONG	AO NG
ONTOG	AO N T AA G
OO	UW
OPERAHAN	AH P EH R AH AH N
OPERASYON	AA P R AH Z IY AO N
OPERATION	AA P ER EY SH AH N
OPERATIONADTO	AH P AH R EY T IY AH N AE D T OW
OPERATIVE	AA P ER AH T IH V
OPERESYON	AA P AH R EH S AY AH N
OPIS	OW P AH S
OPISINA	AH P IH S AH N AH
OPISYAL	AH P IH S AY AH L
OPISYALES	AH P IH S AY EY L Z
ORACION	AH R AH S IY AH N
ORAS	AO R AH Z
ORASA	AO R AH S AH
ORASAN	AO R AH Z AH N
ORDER	AO R D ER
ORINS	AO R AH N Z
ORIZANO	AH R IH Z AH N OW
ORO	AO R OW
OS	AA S
OSAMA	OW S AA M AH
OSAN	OW Z AH N
OSAS	AA S AH Z
OSMENA	AO Z M IY N AH
OSO	AA S OW
OSORIO	OW S AO R IY OW
OSPITAL	AA S P IH T AH L
OT	AO T
OT(2)	OW T IY
OTAN	OW T AH N
OTEN	OW T AH N
OTENTEKEYT	AH T EH N T AH K EY T
OTLEY	AA T L IY
OTRO	AA T R OW
OTRONG	AA T R AH NG
OTSENTA	AA T S EH N T AH
OTSO	AA T S OW
OVER	OW V ER
OYON	OY AH N
P	P IY
PA	P AA
PAA	P AA
PAABUT	P AA B AH T
PAAGIA	P AA JH IY AH
PAALISNGAW	P AH L IH Z N G AH
PAANYAG	P AA N AY AH G
PAARALAN	P AA R AH L AH N
PAARMING	P AA R M AH NG
PABALAY	P AH B AE L EY IY
PABAYLOAN	P AH B EY L OW AH N
PABILIN	P AE B AH L AH N
PABLITA	P AE B L AH T AH
PABOR	P EY B AH R
PABORAATO	P AH B AO R AH T OW
PABORITO	P AH B AO R AH T OW
PABORITONG	P AH B AO R AH T AH NG
PABRIKA	P AE B R AH K AH
PABUTO	P AE B Y UW T OW
PACENCIA	P AH S EH N CH IY AH
PACHO	P AE CH OW
PADALA	P AE D AH L AH
PADALION	P AE D AH L Y AH N
PADAYON	P AE D EY AH N
PADRINO	P AE D R AH N OW
PADULONG	P AE D Y UW L AH NG
PADUNG	P AE D AH NG
PAELLA	P IY L AH
PAG	P AE G
PAGAGSAHAN	P AH G AE G S AH AH N
PAGAKUHAON	P AE G AH K AH HH EY AH N
PAGAWASON	P AH G AO AH S AH N
PAGBAG	P AE G AH G
PAGBAGO	P AE G AH G OW
PAGBAHA	P AE G AH HH AH
PAGBALIK	P AE G AH L AH K
PAGBANTAY	P AE G AE N T EY IY
PAGBASOL	P AE G AH S AH L
PAGBATI	P AE G AH T IY
PAGBAYAW	P AE G EY AH
PAGBAYLOAY	P AE G EY L OW IY
PAGBINAYLOAY	P AE G AH N EY L OW IY
PAGBITAD	P AE G AH T AH D
PAGBITAY	P AE G IH T EY IY
PAGBITBIT	P AE G IH T B AH T
PAGBIYAHE	P AE G IY AY AH HH
PAGBUGA	P AE G Y UW G AH
PAGBUHAT	P AE G AH HH AH T
PAGBUOTSA	P AE G Y UW AA T S AH
PAGBUTANG	P AE G Y UW T AH NG
PAGBUTO	P AE G Y UW T OW
PAGDAGAN	P AE G D AH JH AH N
PAGDAKOP	P AE G D AH K AH P
PAGDAKUP	P AE G D AH K AH P
PAGDALA	P AE G D AH L AH
PAGDALI	P AE G D AH L IY
PAGDANI	P AE G D AH N IY
PAGDASIG	P AE G D AH S AH G
PAGDAWAT	P AE G D AH AH T
PAGDRAWING	P AE G D R AH AH NG
PAGDRAYB	P AE G D R EY B
PAGDUGANG	P AE G D Y UW G AH NG
PAGDUMALA	P AE G D Y UW M AH L AH
PAGDUNGGAB	P AE G D AH N G AH B
PAGDUOL	P AE G D Y UW AH L
PAGDUTDOT	P AE G D AH T D AH T
PAGDUWA	P AE G D AH W AH
PAGGALAB	P AE G AH L AH B
PAGGINHAWA	P AE JH IH N HH AH AH
PAGGUBA	P AE G Y UW B AH
PAGGUNIT	P AE G Y UW N AH T
PAGHAGO	P AE AH G OW
PAGHAGSA	P AE AE G S AH
PAGHANDOM	P AE AH N
PAGHASMAG	P AE AE Z M AH G
PAGHATAG	P AE AH T AH G
PAGHATOD	P AE AH T AH D
PAGHIDANGAT	P AE AH D AE N G AH T
PAGHIGUGMA	P AE AH G AH G M AH
PAGHIKAY	P AE IH K EY IY
PAGHIMO	P AE AH M OW
PAGHUBAD	P AE UW B AH D
PAGHUKOM	P AE UW K AH M
PAGHULAGWAY	P AE AH L AE G W EY IY
PAGHUMAN	P AE UW M AH N
PAGHUNAHUNA	P AH UW N AH HH Y UW N AH
PAGIHAP	P AE JH AH HH AH P
PAGKA	P AE G K AH
PAGKAANAA	P AE G K AH N AH
PAGKAANGOL	P AE G K AA N G AH L
PAGKABAHINBAHIN	P AE G K AH B AH HH IH N B AH HH AH N
PAGKABALDADO	P AE G K AH B AE L D AH D OW
PAGKABATA	P AE G K AE B AH T AH
PAGKABAYO	P AE G K AE B EY OW
PAGKABIG	P AE G K AH B AH G
PAGKABOT	P AE G K AH B AH T
PAGKABUGAS	P AE G K AH B Y UW G AH Z
PAGKABUNTAG	P AE G K AH B AH N T AH G
PAGKABUTANG	P AE G K AH B Y UW T AH NG
PAGKADAIYA	P AE G K AH D EY AY AH
PAGKADALAGA	P AE G K AH D AE L AH G AH
PAGKADISKOBRE	P AE G K AH D IH S AH B AH R
PAGKAEPISYENTE	P AE G K AH P IH S AY AH N T
PAGKAHABA	P AE G K AE HH AH B AH
PAGKAHUGNO	P AE G K AH HH AH G N OW
PAGKAHULOG	P AE G K AE HH Y UW L AH G
PAGKAHUMAN	P AE G K AH HH Y UW M AH N
PAGKAHUOT	P AE G K AE HH Y UW AH T
PAGKAIGO	P AE G K EY G OW
PAGKAIN	P AE G K EY N
PAGKAKARON	P AE G K AE K AH R AH N
PAGKALABAY	P AE G K AH L AE B EY IY
PAGKALABO	P AE G K AE L AH B OW
PAGKALOT	P AE G K AH L AH T
PAGKALUGOS	P AE G K AH L UW G AH Z
PAGKALUTO	P AE G K AH L UW T OW
PAGKAMIYEMBRO	P AE G K EY M IY AY EH M B R OW
PAGKANAUG	P AE G K AH N AH G
PAGKAON	P AE G K EY AH N
PAGKASAYUP	P AE G K AE S EY AH P
PAGKASUNOD	P AE G K AH S UW N AH D
PAGKAT	P AE G K AH T
PAGKATAPOS	P AE G K AE T AH P AH Z
PAGKATAWO	P AE G K AE T AH OW
PAGKATIGULANG	P AE G K AH T AH G Y UW L AH NG
PAGKATINUOD	P AE G K AH T IH N Y UW AH D
PAGKATKAT	P AE G K AE T AH T
PAGKATUMBA	P AE G K AH T AH M B AH
PAGKAUPAW	P AE G K AH P AH
PAGKAWALA	P AE G K AO AH L AH
PAGKAWALIS	P AE G K AO AH L AH S
PAGKAYABO	P AE G K EY AH B OW
PAGKITA	P AE G K AH T AH
PAGKOLEKTA	P AE G K AH L EH K T AH
PAGKUHA	P AE G K AH HH AH
PAGKUNHOD	P AE G K AH N HH AH D
PAGKUTLUON	P AE G K AH T L UW W AH N
PAGLAKAW	P AE G L AH K AH
PAGLALANG	P AE G L AH L AH NG
PAGLALIN	P AE G L AH L AH N
PAGLAMBOS	P AE G L AE M B AH Z
PAGLANGAN	P AE G L AE N G AH N
PAGLAUM	P AE G L AH M
PAGLAYAT	P AE G L EY AH T
PAGLIBANG	P AE G L AH B AH NG
PAGLIHOK	P AE G L AH HH AH K
PAGLINGI	P AE G L IH N JH IY
PAGLINGKOD	P AE G L IH N G K AH D
PAGLUKSO	P AE G L AH K S OW
PAGLUPAD	P AE G L UW P AH D
PAGLUSAD	P AE G L UW S AH D
PAGLUTO	P AE G L UW T OW
PAGMAKITID	P AE G M AE K AH T AH D
PAGMANEHO	P AE G M AE N AH HH OW
PAGMATNGON	P AE G M AE T N G AH N
PAGMATUOD	P AE G M AE T Y UW AH D
PAGMENTINAR	P AE G M EH N T AH N AH R
PAGMINYO	P AE G M IH N AY OW
PAGPA	P AE G P AH
PAGPAABOT	P AE G P AH B AH T
PAGPAAYO	P AE G P AA AY OW
PAGPADALAG	P AE G P AE D AH L AH G
PAGPAHAMTANG	P AE G P AH HH AE M T AH NG
PAGPAHIANGAY	P AE G P AH HH IY AE N G EY IY
PAGPAILA	P AE G P EY L AH
PAGPAKABUHI	P AE G P AH K AE B AH HH IY
PAGPAKAON	P AE G P AE K EY AH N
PAGPAKIG	P AE G P AH K AH G
PAGPALAMBO	P AE G P AH L AE M B OW
PAGPALAPAD	P AE G P AE L AH P AH D
PAGPALAWOM	P AE G P AE L AH AH M
PAGPALIT	P AE G P AH L AH T
PAGPAMALIBAD	P AE G P AH M AE L AH B AH D
PAGPAMALIGYA	P AE G P AH M AH L IH JH AY AH
PAGPAMISA	P AE G P AE M AH S AH
PAGPAMOMBA	P AE G P AH M AA M B AH
PAGPAMUHUNAN	P AE G P AE M AH HH Y UW N AH N
PAGPAMUSIL	P AE G P AH M Y UW S AH L
PAGPANALIPOD	P AE G P AH N AE L AH P AH D
PAGPANAWAT	P AE G P AE N AH AH T
PAGPANGANAOG	P AE G P AH N G AE N EY AH G
PAGPANGAYAM	P AE G P AE N G EY AH M
PAGPANGGA	P AE G P AE N G AH
PAGPANGISDA	P AE G P AH N JH IH Z D AH
PAGPANGITA	P AE G P AE N JH AH T AH
PAGPANGLABA	P AE G P AE N G L AH B AH
PAGPANGLUGOS	P AE G P AH N G L UW G AH Z
PAGPANGSUNOG	P AE G P AH N G S UW N AH G
PAGPANGULO	P AE G P AH N G Y UW L OW
PAGPANGUNDANG	P AE G P AH N G AH N D AH NG
PAGPANGUTANA	P AE G P AH N G Y UW T AH N AH
PAGPANILHIG	P AE G P AH N IH L HH AH G
PAGPASALAMAT	P AE G P AH S AE L AH M AH T
PAGPATAY	P AE G P AE T EY IY
PAGPATIN	P AE G P AH T AH N
PAGPATUMAN	P AE G P AH T Y UW M AH N
PAGPILI	P AE G P AH L IY
PAGPONDO	P AE G P AA N D OW
PAGPORMA	P AE G P AO R M AH
PAGPUSIL	P AE G P Y UW S AH L
PAGRESPONDE	P AE G R EH S AH N D
PAGSAAD	P AE G S AH D
PAGSAGOP	P AE G S AH G AH P
PAGSAGUBANG	P AE G S AH G Y UW B AH NG
PAGSAKA	P AE G S AH K AH
PAGSALBAR	P AE G S AE L B AH R
PAGSALIG	P AE G S AH L AH G
PAGSALOP	P AE G S AH L AH P
PAGSANDIG	P AE G S AE N D AH G
PAGSANONG	P AE G S AH N AH NG
PAGSARAP	P AE G S AH R AH P
PAGSAULOG	P AE G S AH L AH G
PAGSAWAY	P AE G S AO EY IY
PAGSAWOD	P AE G S AH AH D
PAGSIDLAK	P AE G S IH D L AH K
PAGSIGURO	P AE G S IH G Y AH R OW
PAGSILUM	P AE G S AH L AH M
PAGSUBANG	P AE G S UW B AH NG
PAGSUGAL	P AE G S UW G AH L
PAGSUGOD	P AE G S UW G AH D
PAGSUHID	P AE G S AH HH AH D
PAGSUKLI	P AE G S AH K L IY
PAGSULAT	P AE G S UW L AH T
PAGSULAY	P AE G S UW L EY IY
PAGSULONG	P AE G S UW L AH NG
PAGSULTI	P AE G S AH L T IY
PAGSULUD	P AE G S UW L AH D
PAGSUMBAG	P AE G S AH M B AH G
PAGSUNOD	P AE G S UW N AH D
PAGSUOD	P AE G S UW W AH D
PAGSUPORTA	P AE G S AH P AO R T AH
PAGSUSI	P AE G S AH S IY
PAGSUWAT	P AE G S AH W AH T
PAGSUYOP	P AE G S UW W AY AH P
PAGTABANG	P AE G T AH B AH NG
PAGTAGAD	P AE G T AH G AH D
PAGTAMBONG	P AE G T AE M B AH NG
PAGTAN	P AE G T AH N
PAGTANDI	P AE G T AE N D IY
PAGTAPOS	P AE G T AH P AH Z
PAGTARONG	P AE G T AH R AH NG
PAGTIGULANG	P AE G T AH G Y UW L AH NG
PAGTIKUSKUS	P AE G T AH K AH S AH S
PAGTIMBANGTIMBANG	P AE G T IH M B AH N G T IH M B AH NG
PAGTINDOG	P AE G T IH N D AH G
PAGTINO	P AE G T AH N OW
PAGTINUBAGAY	P AE G T IH N Y AH B AE G EY IY
PAGTRABAHO	P AE G T R AE B AH HH OW
PAGTUBO	P AE G T Y UW B OW
PAGTUGOT	P AE G T Y UW G AH T
PAGTUKAS	P AE G T Y UW K AH Z
PAGTUKI	P AE G T Y AH K IY
PAGTUKOD	P AE G T Y UW K AH D
PAGTUKTOK	P AE G T AH K T AH K
PAGTULIS	P AE G T Y AH L AH S
PAGTUMAN	P AE G T Y UW M AH N
PAGTUNGOK	P AE G T AH N G AH K
PAGTUNOL	P AE G T Y UW N AH L
PAGTUON	P AE G T Y UW AH N
PAGTUTOL	P AE G T Y UW T AH L
PAGUMANGKON	P AE G Y AH M AE N G K AH N
PAGYUPYOP	P AE JH AY UW P AY AH P
PAHAT	P AE HH AH T
PAHAYAG	P AE HH EY AH G
PAHINOMDOMI	P AE HH AH N AA M D AH M IY
PAHISUBO	P AE HH AH S UW B OW
PAHIYUM	P AH HH IY AY AH M
PAINGON	P AA IH NG AO N
PAIT	P EY T
PAKA	P AE K AH
PAKALS	P AE K AH L Z
PAKAMATARUNGON	P AH K AE M AH T AH R AH N G AH N
PAKATULGON	P AE K AH T AH L G AH N
PAKIGHINABI	P AE K AY IH N AH B IY
PAKIGPULONG	P AE K AH G P Y UW L AH NG
PAKIGSULTI	P AE K AH G S AH L T IY
PAKIRAMDAM	P AE K AH R AE M D AH M
PAKISUSI	P AE K AH S UW S IY
PAKO	P AE K OW
PAKUYOGA	P AE K Y UW AY AH G AH
PAKYAS	P AE K AY AH Z
PALABOK	P AE L AH B AH K
PALAD	P AE L AH D
PALAMAN	P AE L AH M AE N
PALAS	P AE L AH Z
PALAYO	P AE L EY OW
PALIBOT	P AE L AH B AH T
PALIHOG	P AE L AH HH AH G
PALIT	P AE L AH T
PALITAN	P AE L AH T AH N
PALITAW	P AE L AH T AH
PALITON	P EY L IY T AH N
PALIYA	P EY L IY AY AH
PALO	P AE L OW
PAMAAGI	P AE M AH JH IY
PAMAHAW	P AE M AH HH AH
PAMAKGOT	P AH M AE K G AH T
PAMASIN	P AE M AH S AH N
PAMAT	P AE M AH T
PAMATASAN	P AH M AE T AH Z AH N
PAMATI	P AE M AH T IY
PAMAYHON	P AH M EY HH AH N
PAMILYA	P AH M IH L AY AH
PAMILYANG	P AH M IH L AY AH NG
PAMILYAR	P AH M IH L AY AH R
PAMINAW	P AE M AH N AH
PAMINAWA	P AH M IH N AH AH
PAMINTA	P AH M IH N T AH
PAMUNGGUTAN	P AE M AH N G Y UW T AH N
PAN	P AE N
PANABUT	P AE N AH B AH T
PANAG	P AE N AH G
PANAGBANGA	P AE N AH G AE N G AH
PANAGBANGI	P AE N AH G AE N JH IY
PANAGDULA	P AE N AH G D Y UW L AH
PANAGHIGALAAY	P AE N AH AH G AE L AH IY
PANAGHISGOT	P AE N AH IH Z AH T
PANAGLALIS	P AH N AE G L AH L AH S
PANAGNA	P AH N AE G N AH
PANAGSA	P AH N AE G S AH
PANAGSANGKA	P AE N AH G S AE N G K AH
PANAGSULTI	P AE N AH G S AH L T IY
PANAGTABI	P AH N AE G T AH B IY
PANAGWAY	P AH N AE G W EY IY
PANAHON	P AE N AH HH AH N
PANAKSAN	P AH N AE K S AH N
PANALANGINI	P AE N AH L AE N JH AH N IY
PANAN	P EY N AH N
PANANALITAY	P AE N AH N AH L IH T EY IY
PANANGLITAN	P AH N AE N G L AH T AH N
PANANSINGSING	P AH N AE N S IH N G S AH NG
PANAPTON	P AE N AE P T AO N
PANAS	P AE N AH Z
PANASON	P AE N AH S AH N
PANAW	P AE N AH
PANAY	P AE N EY IY
PANDESAL	P AE N D Z AH L
PANG	P AE NG
PANGADTOAN	P AE N G AE D T OW AH N
PANGAGPAS	P AE N G AE G P AH Z
PANGALAN	P AE N G AH L AH N
PANGANDOY	P AE N G AE N D OW IY
PANGANOD	P AE NG AH N AA D
PANGAON	P AE NG AH AO N
PANGARTE	P AE N G AH R T
PANGAT	P AE N G AH T
PANGHITABO	P AH N IH T AH B OW
PANGIDARON	P AE NG AH D ER AO N
PANGINAHANGLAN	P AE N JH IH N AH HH AE N G L AH N
PANGITAA	P AE N JH AH T AH
PANGKALIGO	P AE N G K AE L AH G OW
PANGLABAW	P AE N G L AH B AH
PANGLIHOK	P AE N G L AH HH AH K
PANGPAGUWAPA	P AE N G P AH G AH W AH P AH
PANGPANG	P AE NG P AE NG
PANGULO	P AE N G Y UW L OW
PANGUMA	P AE N G Y UW M AH
PANGUNA	P AE N G Y UW N AH
PANGUTANA	P AE N G Y UW T AH N AH
PANGUTOK	P AE N G Y UW T AH K
PANIGARILYO	P AE N AH G AH R IH L AY OW
PANIHAPON	P AH N IH HH AH P AH N
PANIMALAY	P AE N IH M AH L EY
PANIMPALAD	P AH N IH M P AH L AH D
PANIMUOT	P AH N IH M Y UW AH T
PANINGKAMOT	P AH N IH N G K AH M AH T
PANIT	P AE N AH T
PANIUDTO	P EY N IY AH D T OW
PANIYA	P EY N IY AY AH
PANLAWAS	P AE N L AH AH Z
PANON	P AE N AO N
PANSAYAN	P AE N S EY AH N
PANSIT	P AE N S IH T
PANTASYA	P AE N T AE S AY AH
PANTS	P AE N T S
PANUDLO	P AH N AH D L OW
PANUG	P AE N AH G
PANUGWAY	P AH N AH G W EY IY
PANUIGON	P AH N UW G AH N
PANUMPA	P AH N AH M P AH
PANYO	P AE N AY OW
PAPA	P AA P AH
PAPALITA	P AH P AE L AH T AH
PAPEL	P AE P AH L
PARA	P EH R AH
PARAAN	P AE R EY AH N
PARAKUL	P AE R AH K AH L
PARANG	P AE R AH NG
PARAT	P AE R AH T
PARDO	P AA R D OW
PAREDES	P AA R EY D EH S
PAREHAS	P AE R AH HH AH Z
PAREHO	P AE R AH HH OW
PARI	P AE R IY
PARKE	P AA R K
PAROROONAN	P AE R AH R UW N AH N
PARTICLE	P AA R T AH K AH L
PARTICLE(2)	P AA R T IH K AH L
PARTY	P AA R T IY
PARYENTE	P AE R AY AH N T
PASADO	P AA Z AH D UW
PASAGDI	P AH S AE G D IY
PASAHERO	P AA Z AH HH IY R OW
PASAKA	P AE S AH K AH
PASALAMAT	P AA Z AH L AH M AE T
PASALIG	P AE S AH L AH G
PASALIGON	P AH S AE L AH G AH N
PASANGINLI	P AE S AH N JH IH N L IY
PASAYLO	P AH S EY L OW
PASAYLOA	P AH S EY L OW AH
PASAYLOAKO	P AE S AH L OW K OW
PASENSIYA	P AE S AH N S IY AY AH
PASENSYA	P AH S EH N S AY AH
PASIDUNGOG	P AE S AH D AH N G AH G
PASIGSUNOT	P AE S AH G S UW N AH T
PASILIDAD	P AH S IH L AH D AH D
PASIUNA	P EY S IY UW N AH
PASIYENTE	P EY S IY AY AH N T
PASKAG	P AE S AH G
PASKO	P AA S K OW
PASO	P AE S OW
PASPAS	P AE S AH Z
PASUKOD	P AH S UW K AH D
PASULTIHON	P AH S AH L T AH HH AH N
PASUNDAYAG	P AH S AH N D EY AH G
PATA	P AE T AH
PATAG	P AE T AH G
PATANAWAKO	P AE T AH N AO AH K OW
PATAS	P AE T AH Z
PATATAS	P AE T AH T AH Z
PATAY	P AE T EY IY
PATAYNG	P AH T EY NG
PATIK	P AE T AH K
PATILAWON	P AE T IH L AH W AH N
PATILYA	P AH T IH L AY AH
PATIS	P EY T IY Z
PATROL	P AH T R OW L
PATUGWAYAN	P AH T AH G W EY AH N
PATUNGO	P AE T AH N G OW
PATUO	P AE T Y UW OW
PATYA	P AE T AY AH
PAUBANA	P AO B AH N AH
PAUBOS	P AO B AH Z
PAUNDAYUNAN	P AO N D EY UW N AH N
PAUNSA	P AO N S AH
PAUSWAGON	P AO S W AH G AH N
PAUTANG	P AO T AH NG
PAWALA	P AO AH L AH
PAWIS	P AO IY Z
PAY	P EY
PAYA	P EY AH
PAYAG	P EY AH G
PAYATON	P EY AH T AH N
PAYONG	P EY AH NG
PAYROLL	P EY R OW L
PAZ	P AA Z
PCAS	K AE Z
PCR	P IY S IY R
PEA	P IY
PEBRERO	P EH B R AH R OW
PEDRO	P EY D R OW
PELI	P EH L IY
PELIKULA	P EH L AH K Y UW L AH
PENSION	P EH N SH AH N
PEOTICA	P IY AA T AH K AH
PEPITO	P EH P AH T OW
PEREZ	P EH R EH Z
PERMI	P AH R M IY
PERPETUAL	P ER P EH CH UW AH L
PERSONALIDAD	P AH R S AH N AE L AH D AH D
PETSA	P EH T S AH
PETSAHA	P EH T S AH HH AH
PHASE	F EY Z
PHILIPPINE	F IH L AH P IY N
PHILIPPINES	F IH L AH P IY N Z
PHONE	F OW N
PIB	P IH B
PIBRERO	P IH B R AH R OW
PIKAS	P IH K AH Z
PIKOY	P IH K OW IY
PILA	P IH L AH
PILAK	P IH L AH K
PILAPIL	P IH L AH P AH L
PILAPILAN	P AH L AE P AH L AH N
PILAY	P IH L EY IY
PILAYEDAD	P AH L EY AH D AH D
PILIA	P IH L Y AH
PILIAN	P IH L IY AH N
PILION	P AY L Y AH N
PILIPAANHON	P IH L AH P AA N HH AH N
PILIPINAS	P AH L IH P AH N AH Z
PILIPINHON	P IH L AH P IH N HH AH N
PILOK	P IH L AH K
PILYA	P IH L AY AH
PINA	P IY N AH
PINAAGI	P IH N AH JH IY
PINAGTULUNG	P IH N AH G T Y UW L AH NG
PINAGTUTULUNGAN	P AH N AE G T Y UW T Y AH L AH N G AH N
PINAKAIMPORTANTENG	P AH N AH K EY M P AH R T AE N T AH NG
PINAKAINTERESADO	P AH N AH K EY N T AH R EH S AH D OW
PINAKAMATALIK	P IH N AH K AH M AE T AH L AH K
PINAKAPABORAATO	P AH N AE K AH P AH B AO R AH T OW
PINAKAPABORITO	P AH N AE K AH P AH B AO R AH T OW
PINAKAPABORITONG	P AH N AE K AH P AH B AO R AH T AH NG
PINAKASUUD	P IH N AH K AE S UW AH D
PINAKBET	P AH N AE K B AH T
PINALABI	P AH N AE L AH B IY
PINALAG	P IH N AH L AE G
PINALANGGA	P IH N AH L AE N G AH
PINANGAT	P AH N AE N G AH T
PINANGGA	P AH N AE N G AH
PINANGGALINGAN	P AH N AE N G AH L IH N G AH N
PINANSYAL	P AH N AE N S AY AH L
PINAPANOOD	P AH N AE P AH N UW D
PINGAG	P IH N G AE G
PINGGAN	P IH N G AH N
PINILI	P IH N AH L IY
PINIRISO	P AH N IH R AH S OW
PINIRITO	P AH N IH R AH T OW
PINO	P IY N OW
PINSA	P IH N S AH
PINUKPOK	P AH N AH K AH K
PINULONGAN	P IH N Y AH L AA N G AH N
PINUNDOK	P AH N AH N D AH K
PINUSILAN	P IH N Y UW Z AH L AH N
PINUY	P IH N Y UW IY
PINUYANAN	P IH N Y UW AY AH N AH N
PIPILA	P IH P AH L AH
PIPILIIN	P IH P AH L IY N
PIQUE	P IY K
PIRMAHAN	P AH R M AH AH N
PIRMI	P AH R M IY
PIRMING	P AH R M AH NG
PISI	P IH S IY
PISKALIYA	P IH S AH L IY AY AH
PISO	P IH S OW
PISTOLA	P IH S T AH L AH
PITAKA	P IH T AH K AH
PITO	P IH T OW
PITONG	P IH T AH NG
PITSI	P IH T S IY
PIYAT	P AY AY AH T
PIYAYA	P AY AY EY AH
PIYESTA	P AY AY EH S T AH
PLACE	P L EY S
PLANNING	P L AE N IH NG
PLANO	P L EY N OW
PLASA	P L AE S AH
PLATA	P L AA T AH
PLATE	P L EY T
PLEMA	P L EH M AH
PLETE	P L IY T
PO	P OW
PO1	P IY OW W AH N
PO2	P IY OW T UW
PO3	P IY OW TH R IY
POBLACION	P AA B L AH S IY AH N
POBRE	P OW B AH R
POCHERO	P AA CH AH R OW
POKER	P OW K ER
POLICARPIO	P AA L AH K AA R P IY OW
POLICE	P AH L IY S
POLIS	P OW L AH S
POLIS(2)	P OW L AY Z
POND	P AA N D
PONG	P AO NG
PORBIDA	P AO R B AH D AH
PORMA	P AO R M AH
PORMAL	P AO R M AH L
PORMULA	P AO R M Y UW L AH
PORNOGRAPHY	P AO R N AA G R AH F IY
PORSIYENTO	P AO R S IY AY EH N T OW
PORTAHAN	P AO R T AH AH N
POSEBLING	P AH S EH B L AH NG
POSIBLENG	P AH S IH B L AH NG
POSIBLI	P AH S IH B L IY
POSIBLING	P OW Z AH B AH L IH NG
POST	P OW S T
POSTE	P OW S T
POTOT	P AA T AH T
PRANSIYA	P R AE N S IY AY AH
PRAYERS	P R EH R Z
PRAYERS(2)	P R EY ER Z
PRESIDENTE	P R IY S IH D AH N T
PRESINTO	P R IY S IH N T OW
PRESKO	P R IY S OW
PRESS	P R EH S
PRESYO	P R IY S AY OW
PRESYUN	P R IY S AY AH N
PRIBADO	P R IH B AH D OW
PRIMARYA	P R AH M AE R AY AH
PRINCESA	P R IH N S AH S AH
PRISYO	P R IH S AY OW
PRITO	P R IH T OW
PROBLEMA	P R OW B L EH M AH
PROFESSIONALS	P R AH F EH SH AH N AH L Z
PROPER	P R AA P ER
PROYEKTO	P R OW Y EH K T OW
PRUSISYON	P R UW S IH S AY AH N
PRUTAS	P R UW T AH Z
PUBLIKO	P AH B L AH K OW
PUD	P AH D
PUERTO	P W EH R T OW
PUERTO(2)	P AO R T AH
PUERTO(3)	P AO R T ER
PUGHAW	P AH G HH AO
PUGONG	P Y UW G AH NG
PUGOS	P AH G AA S
PUHON	P AH HH AH N
PUKAWA	P Y UW K AH AH
PULA	P Y UW L AH
PULGADA	P UH L G AH D AH
PULIS	P Y UW L AH S
PULONG	P Y UW L AH NG
PULOS	P UW L OW Z
PULSO	P UH L S OW
PULTAHAN	P UH L T AH AH N
PULUTIN	P Y UW L UW T AH N
PUMAPALIT	P Y UW M AE P AH L AH T
PUMUTAK	P Y UW M Y UW T AH K
PUN	P AH N
PUNDASYON	P AH N D AE S AY AH N
PUNDO	P AH N D UW
PUNDOK	P AH N D AH K
PUNERARYA	P Y UW N AH R AE R AY AH
PUNG	P AH NG
PUNGANGO	P AH N G AE N G OW
PUNGKOT	P AH N G K AH T
PUNLAS	P AH N L AH Z
PUNO	P Y UW N OW
PUNOAN	P Y UW N OW AH N
PUNOANG	P Y UW N OW NG
PUNTOD	P AH N T AH D
PUNUAN	P Y UW N Y UW AH N
PURAY	P Y UH R EY IY
PURISIMA	P Y AH R IH S AH M AH
PURO	P Y UH R OW
PUROK	P Y UH R AH K
PUROL	P Y UH R AH L
PURSUIT	P ER S UW T
PURTAHAN	P AH R T AH AH N
PUS	P AH S
PUSIL	P Y UW S AH L
PUSO	P Y UW S OW
PUSOD	P Y UW S AH D
PUSTA	P AH S T AH
PUTAHE	P Y UW T AH HH
PUTHAW	P UH T HH AO
PUTI	P Y UW T IY
PUTION	P UH SH AH N
PUTLI	P AH T L IY
PUTO	P Y UW T OW
PUTOS	P UH T AA S
PUTOSA	P Y UW T AH S AH
PUWA	P AH W AH
PUWEDENG	P AH W AH D AH NG
PUY	P Y UW IY
PUYO	P Y UW AY OW
PWEDE	P W IY D
PWERSA	P W AH R S AH
QUIANOLA	K W AY AE N AH L AH
QUIO	K W AY OW
RA	R AA
RADIO	R EY D IY OW
RADYO	R AE D AY OW
RALLOS	R AE L AH Z
RAMA	R AA M AH
RAMESES	R AE M AH S IY Z
RAMISO	R AE M AH S OW
RANSOM	R AE N S AH M
RASON	R AE S AH N
RAY	R EY
RAYMOND	R EY M AH N D
REBELDE	R IH B AH L D IY
REBELDING	R EH B EH L D IH NG
RECOVER	R IH K AH V ER
REGALO	R AH G AE L OW
REGION	R IY JH AH N
REGIONAL	R IY JH AH N AH L
REGISTERED	R EH JH IH S T ER D
REHAS	R AH HH AE Z
REHIYON	R AH HH AY AY AH N
REKLAMO	R IH K L AE M OW
RELASYON	R AH L AE S AY AH N
RELATION	R IY L EY SH AH N
RELO	R AH L OW
RELYENO	R AH L AY AH N OW
REMEGIO	R AH M IY JH IY OW
REMOTIGUE	R AH M AA T AH G
RENATO	R EH N AA T OW
REPORT	R IY P AO R T
REPORT(2)	R IH P AO R T
REPORTERS	R IH P AO R T ER Z
REPRESENTANTE	R IH P R AH S EH N T AH N T
REPUTATION	R EH P Y AH T EY SH AH N
RESIDENTE	R AH S IH D AH N T
RESOLOSYON	R IY S OW L OW Z IY AO N
RESPETUHAN	R IH S EH T AH AH N
RESTAURANT	R EH S T ER AA N T
RESTAURANT(2)	R EH S T R AA N T
RESULTA	R AH S AH L T AH
REVENUE	R EH V AH N UW
REVENUE(2)	R EH V AH N Y UW
REVOLVER	R IH V AA L V ER
REYES	R EY IH S
RFID	R F IH D
RICARDO	R IH K AA R D OW
RICHARD	R IH CH ER D
RICKY	R IH K IY
RIFLE	R AY F AH L
RITCHIE	R IH CH IY
RIVERA	R IH V EH R AH
ROBINSONS	R AA B AH N S AH N Z
ROCHELLE	R OW SH EH L
ROCHELLE(2)	R AH SH EH L
RODELITO	R AH D EH L AH T OW
RODELLO	R AH D EH L OW
RODRIGO	R AH D R IY G OW
RODRIGUEZ	R AA D R IY G EH Z
RODULFO	R AH D AH L F OW
ROLANDO	R OW L AA N D OW
ROMEL	R OW M AH L
ROMEO	R OW M IY OW
ROMUALDEZ	R AA M Y UW AE L D AH Z
RON	R AA N
RONALD	R AA N AH L D
RONG	R AO NG
ROOM	R UW M
ROON	R UW N
ROSA	R OW Z AH
ROSALES	R OW S EY L Z
ROSALITO	R AH S AE L AH T OW
ROSARIO	R OW Z AA R IY OW
ROSAS	R OW Z AH Z
RTC	AA R T IY K
RUDY	R UW D IY
RUEL	R UW L
RUIZ	R UW IY Z
RURAL	R UH R AH L
RUSEL	R UW S AH L
RUSSEL	R AH S AH L
RUTHE	R AH DH
SA	S AA
SAAN	S EY AH N
SAANG	S AA NG
SAANGKO	S AA N G K OW
SAAS	S AA Z
SAB	S AE B
SABA	S AA B AH
SABAAN	S AE B EY AH N
SABADO	S AE B AH D OW
SABAKAN	S AE B AH K AH N
SABAW	S AE B AH
SABDYEK	S AE B D AY AH K
SABERON	S EY B ER AO N
SABON	S AE B AH N
SABONG	S AE B AH NG
SABTON	S AE B T AH N
SAD	S AE D
SADDAM	S AA D AH M
SADDAM(2)	S AH D AA M
SAG	S AE G
SAGBUT	S AE G AH T
SAGDI	S AE G D IY
SAGING	S EY JH IH NG
SAGOL	S AE G AH L
SAGOT	S AE G AH T
SAGUNSON	S AE G AH N S AH N
SAHA	S AA HH AH
SAKA	S AE K AH
SAKAY	S AE K EY IY
SAKAYAN	S AE K EY AH N
SAKIT	S AE K AH T
SAKITA	S AE K AH T AH
SAKO	S AA K OW
SAKOP	S AE K AH P
SAKRIPISYO	S AE K R AH P IH S AY OW
SAKSI	S AE K S IY
SAKTO	S AE K T OW
SAKUP	S AE K AH P
SAKYAN	S AE K AY AH N
SAKYANAN	S AH K AY AH N AH N
SALA	S AA L AH
SALABUTAN	S AE L AH B Y UW T AH N
SALAMAT	S AE L AH M AH T
SALAMIN	S AE L AH M AH N
SALAPI	S AE L AH P IY
SALIDA	S AE L AH D AH
SALIG	S AE L AH G
SALIN	S AA L IY N
SALITA	S AE L AH T AH
SALO	S AA L OW
SALOG	S AE L AH G
SALUMSUM	S AH L AH M Z AH M
SALUWAL	S AE L AH W AH L
SAMA	S AA M AH
SAMAD	S AE M AH D
SAMARAN	S AE M AH R AH N
SAMBAG	S AE M B AH G
SAMOK	S AE M AH K
SAMPURADO	S AE M P Y UH R AH D OW
SAMPUT	S AE M P AH T
SAMTANG	S AE M T AH NG
SAN	S AE N
SANCHEZ	S AE N CH EH Z
SANCIANGKO	S AE N S IY AE N G K OW
SANGA	S AE N G AH
SANGGAB	S AE NG G AE B
SANGKAP	S AE N G K AH P
SANGKO	S AE N G K OW
SANGLIT	S AE NG L IH T
SANGPUTANAN	S AE N G P Y UW T AH N AH N
SANTIK	S AE N T AH K
SANTOS	S AE N T OW S
SAOP	S EY AH P
SAPA	S AE P AH
SAPATOS	S AE P AH T AH Z
SAPAYAN	S AE P EY AH N
SAPIENS	S EY P IY AH N Z
SAPIN	S AE P IH N
SAPNOT	S AE P N AH T
SAPOT	S AE P AH T
SAPUT	S AE P AH T
SARA	S EH R AH
SARCO	S AA R K OW
SARHENTO	S AH R EH N T OW
SARHENTOHA	S AH R EH N T AH HH AH
SARILING	S AA R IY L IH NG
SARSYADO	S AA R S AY AH D OW
SASABIHIN	S AH S AE B AH HH AH N
SATUO	S AE T Y UW OW
SAWAG	S AO AH G
SAYA	S EY AH
SAYAG	S EY AH G
SAYANG	S EY AH NG
SAYAW	S EY AH
SAYO	S EY OW
SAYOP	S EY AH P
SAYUP	S EY AH P
SCENE	S IY N
SCHOOL	S K UW L
SECTION	S EH K SH AH N
SECURITY	S IH K Y UH R AH T IY
SEGUNDA	S AH G AH N D AH
SEGUNDO	S EH G UH N D OW
SEGURIDAD	S EH G Y UH R AH D AH D
SEGURO	S EH G Y AH R OW
SEGURONG	S EH G Y AH R AH NG
SEKSIRIKA	S EH K S IH R AH K AH
SEKSO	S EH K S OW
SELEBRASYON	S EH L AH B R AE S AY AH N
SEMANA	S EH M AH N AH
SEMINAR	S EH M AH N AA R
SENSILYO	S EH N S IH L AY OW
SENSIYO	S EH N S IY AY OW
SENTIMO	S EH N T AH M OW
SENTIMOS	S EH N T IH M AA S
SENTRO	S EH N T R OW
SEPA	S EH P AH
SERBILYETA	S AH R B AH L AY AH T AH
SEREMONYA	S EH R AH M AA N AY AH
SERRANO	S ER AA N OW
SERRANO(2)	S ER AE N OW
SETYEMBRE	S EH T AY EH M B AH R
SEVEN	S EH V AH N
SEVENTEEN	S EH V AH N T IY N
SEVENTY	S EH V AH N T IY
SEX	S EH K S
SHABU	SH AE B UW
SHAINA	SH EY N AH
SHELL	SH EH L
SHERIFF	SH EH R AH F
SHERIFF(2)	SH EH R IH F
SHIMURA	SH IH M Y AH R AH
SHOTGUN	SH AA T G AH N
SI	S IY
SIBIL	S IH B AH L
SIBILYAN	S AH B IH L AY AH N
SIDLAK	S IH D L AH K
SIDLIT	S IH D L AH T
SIGA	S IH G AH
SIGARILYO	S IH G AH R IH L AY OW
SIGARILYONG	S IH G AH R IH L AY AH NG
SIGE	S AY JH
SIGI	S IH JH IY
SIGLO	S IH G L OW
SIGPIT	S IH G P AH T
SIGUN	S IH G AH N
SIGURADO	S IH G Y UH R AH D OW
SIGURADONG	S IH G Y UH R AH D AH NG
SIGURONG	S IH G Y AH R AH NG
SIHIG	S IH HH AH G
SIKAT	S IH K AH T
SIKATUNA	S IH K AH T Y UW N AH
SIKO	S IH K OW
SIKOP	S IH K AH P
SIKWATI	S IH K W AH T IY
SILA	S IH L AH
SILAG	S IH L AH G
SILANGAN	S AH L AE N G AH N
SILAW	S IH L AH
SILAY	S IH L EY IY
SILAYNON	S AH L EY N AH N
SILINGAN	S AH L IH N G AH N
SILINGANG	S AH L IH N G AH NG
SILONG	S IH L AH NG
SILYA	S IH L AY AH
SIMBAHAN	S IH M B AH AH N
SIMBAKO	S IH M B AH K OW
SIMON	S AY M AH N
SINAGOL	S IH N AH G AH L
SINAGOLAN	S AH N AE G AH L AH N
SINAGULAN	S AY N IH JH AH L AH N
SINAGUP	S IH N AH G AH P
SINAKANG	S IH N AH K AH NG
SINAKONG	S IH N AH K AH NG
SINALIRAP	S AH N AE L AH R AH P
SINANGAG	S AH N AE N G AH G
SINANSAN	S AH N AE N Z AH N
SINASAKYAN	S IH N AH S AE K AY AH N
SINDIKATO	S IH N D IH K AH T OW
SINE	S AY N
SINEHAN	S IH N AH AH N
SINGGIT	S IH N JH AH T
SINGKO	S IH N G K OW
SINGKWENTA	S IH N G K W EH N T AH
SINIBO	S IH N AH B OW
SINIHAN	S IH N AH AH N
SININA	S IH N AH N AH
SINO	S AY N OW
SINSILYO	S IH N S IH L AY OW
SINSIYO	S IH N S IY AY OW
SINTURON	S IH N T Y AH R AH N
SINUBAKAN	S IH N Y UW B AH K AH N
SINUBONG	S IH N Y UW B AH NG
SINUDLAN	S AH N AH D L AH N
SINUGBA	S AH N AH G AH
SINUGDANAN	S AH N AH G D AH N AH N
SIPA	S IY P AH
SIPI	S IH P IY
SIPILYO	S AH P IH L AY OW
SIR	S ER
SIRIGUYLAS	S AH R IH G W AH L AH Z
SIRO	S IH R OW
SITIO	S IH T IY OW
SITYEMBRE	S IH T AY EH M B AH R
SITYO	S IH T AY OW
SIX	S IH K S
SIXTEEN	S IH K S T IY N
SIXTY	S IH K S T IY
SIYA	S AY AY AH
SIYAG	S AY AY AH G
SIYAGIT	S AY AY AH JH AH T
SIYAM	S AY AY AH M
SIYANG	S AY AY AH NG
SIYARO	S AY AY AH R OW
SIYAY	S AY AY EY IY
SIYEMPRE	S AY AY EH M P AH R
SIYUDAD	S AY AY UW D AH D
SOBRA	S AA B R AH
SOBRANG	S AA B R AE NG
SOBRE	S OW B AH R
SOLAYI	S AA L EY IY
SOLIMA	S AA L AH M AH
SOLIMAN	S AA L IH M AH N
SOLOD	S AA L AH D
SOPA	S OW P AH
SORISO	S AO R AH S OW
SOSON	S OW Z AO N
SOTIL	S AA T AH L
SOTTO	S AA T OW
SOUTHERN	S AH DH ER N
SPEAKER	S P IY K ER
SPECIES	S P IY SH IY Z
SPIRIT	S P IH R AH T
SPIRIT(2)	S P IH R IH T
SPO1	EH S P IY OW W AH N
SPO2	EH S P IY OW T UW
SPOKESPERSON	S P OW K S P ER S AH N
SPOT	S P AA T
SR	S IY N Y ER
SR(2)	S IH S T ER
SRP	EH S AA R P
ST	EH S T
STAFF	S T AE F
STAR	S T AA R
STATION	S T EY SH AH N
STOCKMAN	S T AA K M AH N
SUBAK	S AH B AE K
SUBAY	S AH B EY IY
SUBDIVISION	S AH B D IH V IH ZH AH N
SUBIC	S UW B IH K
SUBLING	S AH B L IH NG
SUCCOUR	S AH K AH R
SUD	S AH D
SUDLANAN	S AH D L AH N AH N
SUG	S AH G
SUGA	S UW G AH
SUGANG	S UW G AH NG
SUGBO	S AH G OW
SUGBU	S AH G UW
SUGILANON	S UW JH IH L AH N AH N
SUGNOD	S AH G N AH D
SUGO	S UW G OW
SUGYOT	S UW JH AY AH T
SUHOL	S AH HH AH L
SUICO	S UW K OW
SUKA	S UW K AH
SUKAD	S UW K AH D
SUKARAN	S UW K AH R AH N
SUKARANAN	S UW K AE R AH N AH N
SUKDI	S AH K D IY
SUKI	S UW K IY
SUKING	S UW K AH NG
SUKLI	S AH K L IY
SUKMAG	S AH K M AH G
SUKO	S UW K OW
SUKOD	S UW K AH D
SUKOT	S UW K AH T
SULA	S UW L AH
SULAAN	S UW L EY AH N
SULAB	S UW L AH B
SULAT	S UW L AH T
SULOD	S UW L AH D
SULTI	S AH L T IY
SULTIHI	S AH L T AH HH IY
SULUD	S UW L AH D
SULUNDON	S UW L AH N D AH N
SUMA	S UW M AH
SUMALA	S UW M AH L AH
SUMBAG	S AH M B AE G
SUMBONG	S AH M B AA NG
SUMPAY	S AH M P EY
SUMSUMAN	S AH M Z UW M AH N
SUN	S AH N
SUNDALO	S AH N D AH L OW
SUNDAWO	S AH N D AH OW
SUNGAY	S AH N G EY
SUNGOHON	S AH N G AH HH AH N
SUNOD	S UW N AH D
SUNOG	S UW N AH G
SUNSTAR	S AH N S T AA R
SUOD	S UW W AH D
SUOK	S UW W AH K
SUPERBALITA	S UW P AH R B AE L AH T AH
SUPREMA	S AH P R AH M AH
SUPT	S AH P T
SURRENDER	S ER EH N D ER
SUS	S AH S
SUSAMA	S UW S AH M AH
SUSAMANG	S UW S AH M AH NG
SUSIHON	S UW S AH HH AH N
SUSO	S UW S OW
SUSPAS	S AH S AH Z
SUSPE	S AH S
SUSPEK	S AH S AH K
SUSPETSADO	S AH S EH T S AH D OW
SUSUNOD	S UW S UW N AH D
SUWANG	S AH W AH NG
SUWELDO	S AH W EH L D OW
SUWERTE	S AH W AH R T
SWELDO	S W EH L D OW
SWERTE	S W AH R T
SYENTO	S AY EH N T OW
SYETE	S AY IY T
SYUDAD	S AY UW D AH D
TA	T AA
TAAS	T AA Z
TABADA	T AE B AH D AH
TABANG	T AE B AH NG
TABANGAN	T AH B AE N G AH N
TABASA	T AE B AH S AH
TABASAN	T AE B AH Z AH N
TABI	T AE B IY
TABIAN	T EY B IY AH N
TABLA	T AE B L AH
TABLETAS	T AE B L AH T AH Z
TABOANAN	T AH B OW N AH N
TABOK	T AE B AH K
TABON	T AE B AO N
TABONTABON	T AE B AO N T AE B AO N
TABUNON	T AE B AH N AO N
TACUL	T AE K AH L
TAG	T AE G
TAGA	T AE G AH
TAGADIIN	T AE G AH D IY N
TAGAI	T AE G EY
TAGALOG	T AE G AH L AA G
TAGBALAY	T AE G AE L EY IY
TAGBANTE	T AE G AH N T
TAGDUGAY	T AE G D Y UW G EY IY
TAGHOY	T AE G HH OW IY
TAGOD	T AE G AH D
TAGPILA	T AE G P AH L AH
TAGSA	T AE G S AH
TAGSAON	T AE G Z AH AO N
TAGSULAT	T AE G S UW L AH T
TAGTUNGOD	T AE G T AH N G AH D
TAGUTLO	T AH G AH T L OW
TAHAS	T AE HH AH Z
TAHO	T AE HH OW
TAHOM	T AE HH AH M
TAK	T AE K
TAKE	T EY K
TAKOB	T AE K AH B
TAKOP	T AE K AH P
TAKOT	T AE K AH T
TAKSANAN	T AE K S AH N AH N
TAKSI	T AE K S IY
TAKUB	T AE K AH B
TAKULAHAW	T AE K Y UW L AH HH AH
TAKUP	T AE K AH P
TALAGSA	T AH L AE G S AH
TALAGSAON	T AH L AE G S EY AH N
TALAGSAONG	T AH L AE G S EY AH NG
TALAKAG	T AE L AH K AH G
TALAMBAN	T AH L AE M B AH N
TALAN	T EY L AH N
TALI	T AE L IY
TALIGSIK	T AH L IH G S AH K
TALINO	T AE L AH N OW
TALIWA	T AE L AH W AH
TALIWALA	T AH L IH W AH L AH
TALONG	T AE L AH NG
TALUDTOD	T AH L AH D T AH D
TAM	T AE M
TAMALA	T AE M AH L AH
TAMBAG	T AE M B AH G
TAMBAGI	T AE M B AH JH IY
TAMBAL	T AE M B AH L
TAMBALAN	T AE M B AH L AH N
TAMBALANAN	T AE M B AE L AH N AH N
TAMBAY	T AE M B EY IY
TAMBLER	T AE M B L AH R
TAMBOK	T AE M B AH K
TAMBUK	T AE M B AH K
TAMPIHAK	T AE M P AH HH AH K
TAMPILAK	T AE M P AH L AH K
TAMPOS	T AE M P AA S
TAMSI	T AE M Z IY
TAN	T AE N
TANA	T AE N AH
TANAMAN	T AE N AH M AE N
TANAN	T EY N AH N
TANANG	T AE N AH NG
TANAWA	T AE N AH AH
TANAWAN	T AE N AH W AA N
TANAWON	T AE N AH W AH N
TANG	T AE NG
TANG(2)	T AA NG
TANGA	T AE N G AH
TANGAN	T AE N G AH N
TANGKUGO	T AE N G K Y UW G OW
TANOD	T AE N AH D
TAO	T AW
TAO(2)	D AW
TAONG	T EY AH NG
TAPA	T AE P AH
TAPAD	T AE P AH D
TAPAL	T EY P AH L
TAPOLAN	T AE P AH L AH N
TAPOS	T AE P AA S
TAPSILOG	T AE P S AH L AH G
TAPUK	T AE P AH K
TAPULAN	T AE P Y AH L AH N
TAPUS	T EY P AH S
TAS	T AE Z
TATAK	T AE T AH K
TATAY	T AE T EY IY
TATLONG	T AE T L AO NG
TAUD	T AO D
TAURON	T AO R AH N
TAW	T AO
TAWAGAN	T AO AH JH AH N
TAWAGON	T AO AH G AH N
TAWO	T AO OW
TAWON	T AO AH N
TAWONG	T AO AH NG
TAXI	T AE K S IY
TAYA	T EY AH
TAYTAYAN	T EY T EY AH N
TAYUD	T EY AH D
TEBAN	T IY B AH N
TEJERO	T EH JH AH R OW
TEKYA	T EH K AY AH
TELEBISYON	T EH L AH B AY Z IY AO N
TELEPONO	T AH L EH P AH N OW
TELEPUNO	T EH L AH P Y UW N OW
TEMPERATURA	T EH M P AH R AE T Y AH R AH
TEMPORARYONG	T EH M P AH R AE R AY AH NG
TEN	T EH N
TENIS	T EH N IY Z
TENSION	T EH N SH AH N
TERCERO	T ER CH EH R OW
TERM	T ER M
TERMINAL	T ER M AH N AH L
TERO	T EH R OW
TEROY	T EH R OW IY
TEST	T EH S T
TESTIGO	T EH S T AH G OW
TEXT	T EH K S T
THE	DH AH
THE(2)	DH IY
THIRD	TH ER D
THIRTEEN	TH ER T IY N
THIRTY	TH ER D IY
THIS	DH IH S
THREE	TH R IY
TIAW	T AY AH W
TIAWAN	T AY AH W AH N
TIBUOK	T IH B Y UW AH K
TIBUUK	T IH B Y UW AH K
TIEMPO	T IY M P OW
TIGABALITA	T IH G AH B AE L AH T AH
TIGBALIGYA	T IH G AH L IH JH AY AH
TIGBALITA	T IH G AE L AH T AH
TIGDALA	T IH G D AH L AH
TIGDESINYO	T IH G D AH S IH N AY OW
TIGDUMALA	T IH G D Y UW M AH L AH
TIGGAMA	T IH G AH M AH
TIGHATAG	T AY AH T AH G
TIGHIMO	T AY AH M OW
TIGKUHA	T IH G K AH HH AH
TIGPAMINAW	T IH G P AE M AH N AH
TIGPAMUHUNAN	T IH G P AE M AH HH Y UW N AH N
TIGTUKOD	T IH G T Y UW K AH D
TIGULANG	T IH G Y UW L AH NG
TIGUM	T IH G AH M
TIGUWANG	T IH G AH W AH NG
TIIL	T IY L
TIKATIK	T IH K AH T AH K
TIKOD	T IH K AH D
TIKUD	T IH K AH D
TILAPIA	T AH L EY P IY AH
TIMAAN	T IH M EY AH N
TIMAILHAN	T AH M EY L AH N
TIMAN	T AY M AH N
TIMBANG	T IH M B AH NG
TIMGAS	T IH M G AH Z
TIMO	T IH M OW
TIMOON	T AH M UW N
TIMPURAN	T IH M P Y AH R AH N
TINABAL	T IH N AH B IY AH L
TINAE	T IH N IY
TINAGOAN	T AH N AE G OW AH N
TINAGOD	T IH N AH G AA D
TINAI	T IH N EY
TINANIM	T IH N AH N AH M
TINAP	T IH N AH P
TINAPA	T IH N AH P AH
TINAPAY	T IH N AH P EY
TINDAHAN	T IH N D AH AH N
TINDOG	T IH N D AO G
TINEDYER	T AY N D AY ER
TINENTE	T IH N AH N T
TING	T IH NG
TINGALI	T IH N G AH L IY
TINGDAGDAG	T IH N G D AE G D AH G
TINGGA	T IH N G AH
TINGKAGOL	T IH N G K AH G AH L
TINGMALA	T IH N G M AH L AH
TINGOG	T IH N G AH G
TINGPAMAHAW	T IH N G P AE M AH HH AH
TINGPAMULAK	T IH N G P AH M Y UW L AH K
TINGTUGNAW	T IH N G T AH G N AH
TINGTUNGHA	T IH N G T AH N AH
TINGUHA	T IH N G AH HH AH
TINIDOR	T AY N AH D ER
TINORTILYAS	T IH N AH R T IH L AY AH Z
TINUD	T IH N AH D
TINUGKAN	T AH N AH G K AH N
TINUIG	T AH N UW G
TINUMOTUMO	T IH N Y UW M AH T Y UW M OW
TINUNUANG	T IH N Y UW N Y UW AH NG
TINUOD	T IH N Y UW AH D
TINUOHAN	T IH N Y UW AH AH N
TINUORAY	T IH N Y UW AO R EY IY
TINUSTOS	T AH N AH S T AH Z
TINUUD	T IH N Y UW AH D
TINUWA	T IH N AH W AH
TINUYO	T IH N Y UW AY OW
TIPASI	T IH P AH S IY
TIPIK	T IH P AH K
TISA	T IH S AH
TITULO	T IH T Y UW L OW
TIYA	T AY AY AH
TIYAGA	T AY AY AH G AH
TIYAN	T AY AY AH N
TIYO	T AY AY OW
TO	T UW
TO(2)	T IH
TO(3)	T AH
TOB	T AA B
TOCHO	T AA CH OW
TOKAYO	T AA K EY OW
TOKWA	T AA K W AH
TOLO	T OW L OW
TOMAS	T OW M AA S
TORIL	T AO R AH L
TORREON	T AO R IY AH N
TORTA	T AO R T AH
TOSINO	T AA S AH N OW
TOTOY	T AA T OW IY
TOYO	T OW Y OW
TOYU	T OY UW
TRABAHO	T R AE B AH HH OW
TRABAHOAN	T R AH B AE HH OW AH N
TRABAHONG	T R AE B AH HH AH NG
TRABAHUA	T R AH B AE HH Y UW AH
TRAFFIC	T R AE F IH K
TRAK	T R AE K
TRANSIT	T R AE N Z IH T
TRAPIKO	T R AE P AH K OW
TRATO	T R AE T OW
TRCANTA	T R K AE N T AH
TRENTA	T R EH N T AH
TRES	T R Z
TRIAL	T R AY AH L
TRIAL(2)	T R AY L
TRIANGLE	T R AY AE NG G AH L
TRIBUTE	T R IH B Y UW T
TRIENTA	T R IY N T AH
TRIMMED	T R IH M D
TRINIDAD	T R IH N IH D AE D
TRIPULANTE	T R IH P Y UW L AH N T
TRUCK	T R AH K
TSAA	T S AA
TSART	T S AA R T
TSEKE	T S IY K
TSINOY	T S IH N OW IY
TSIRMAN	T S AH R M AH N
TU	T UW
TUA	T Y UW AH
TUALYA	T Y UW AE L AY AH
TUAS	T Y UW AH Z
TUBA	T UW B AH
TUBAG	T Y UW B AH G
TUBIG	T Y UW B AH G
TUBO	T Y UW B OW
TUBURAN	T Y UW B Y AH R AH N
TUDLING	T AH D L AH NG
TUDLO	T AH D L OW
TUGBANG	T AH G B AE NG
TUGKARAN	T AH G K AH R AH N
TUGNAW	T AH G N AH
TUGOTI	T Y UW G AH T IY
TUGUEGARAO	T Y UW G W AH G AE R EY OW
TUHOD	T AH HH AH D
TUIG	T UW G
TUIGA	T UW G AH
TUKMA	T AH K M AH
TUKMANG	T AH K M AH NG
TULAY	T Y UW L EY IY
TULID	T Y UW L AH D
TULIS	T Y UW L AH S
TULISA	T Y UW L AH S AH
TULISAN	T Y UW L AH S AH N
TULO	T Y UW L OW
TULOD	T Y UW L AH D
TULOY	T Y UW L OW IY
TULUNGAN	T Y UW L AH N G AH N
TULUTINAMOD	T Y UW L AH T IH N AH M AH D
TUMARA	T Y UW M AH R AH
TUMONG	T Y UW M AH NG
TUMOY	T Y UW M OW IY
TUNDAG	T AH N D AH G
TUNGA	T AH N G AH
TUNGANG	T AH N G AH NG
TUNGKOL	T AH N G K AH L
TUNGOD	T AH N G AH D
TUNGOL	T AH N G AH L
TUNGORA	T AH N G AH R AH
TUNLA	T AH N L AH
TUNOKONG	T Y UW N AH K AH NG
TUO	T Y UW OW
TUOD	T Y UW AH D
TUON	T Y UW AH N
TUONG	T Y UW AH NG
TUPAD	T Y UW P AH D
TURA	T Y UH R AH
TURAN	T Y UH R AH N
TURISTA	T Y AH R IH S T AH
TURNO	T AH R N OW
TUSTADO	T AH S T AH D OW
TUTUNLAN	T Y UW T AH N L AH N
TUWALYA	T AH W AA L AY AH
TUYO	T Y UW AY OW
TUYOA	T Y UW AY OW AH
TUYOK	T Y UW AY AH K
TUYOM	T Y UW AY AH M
TWELVE	T W EH L V
TWENTY	T W EH N T IY
TWO	T UW
U	Y UW
UALAT	Y UW AH L AH T
UBAN	Y UW B AH N
UBANAN	Y UW B EY N AH N
UBANG	Y UW B AH NG
UBATAY	Y UW B AE T EY IY
UBAY	Y UW B EY IY
UBO	Y UW B OW
UBOS	Y UW B AH Z
UBP	AH B P
UBUS	Y UW B AH S
UDLOT	AH D L AH T
UDTO	AH D T OW
UDTONG	AH D T AH NG
UG	AH G
UGA	Y UW G AH
UGAN	Y UW G AH N
UGANGAN	Y UW G AE N G AH N
UGAT	Y UW G AH T
UGMA	AH G M AH
UGOD	Y UW G AH D
UHAW	AH HH AH
UKI	Y UW K IY
UKOL	Y UW K AH L
ULAHI	Y UW L AH HH IY
ULAHING	Y UW L AH AH NG
ULAN	Y UW L AH N
ULAT	Y UW L AH T
ULHOS	AH L HH AH Z
ULITAWO	Y UW L IH T AH OW
ULO	Y UW L OW
ULOHAN	Y UW L AH AH N
ULTIMO	AH L T AH M OW
UM	AH M
UMA	Y UW M AH
UMAABOT	Y UW M AH B AH T
UMABOT	Y UW M AH B AH T
UMAGAD	Y UW M AH G AH D
UMAN	Y UW M AH N
UMANGKON	Y UW M AE N G K AH N
UMARI	Y UW M AH R IY
UMOG	Y UW M AH G
UMON	Y UW M AH N
UN	AH N
UN(2)	Y UW EH N
UNA	UW N AH
UNAHAN	AH N AE AH N
UNAN	Y UW N AH N
UNANG	AH N AE NG
UNDER	AH N D ER
UNDO	AH N D UW
UNGGOY	AH N G OW IY
UNIT	Y UW N AH T
UNIT(2)	Y UW N IH T
UNITS	Y UW N AH T S
UNITS(2)	Y UW N IH T S
UNLAN	AH N L AH N
UNO	AH N OW
UNO(2)	UW N OW
UNOD	AH N AA D
UNOM	AH N AA M
UNOS	UW N OW Z
UNSA	AH N S AA
UNSANG	AH N S AE NG
UNSAON	AH N S EY AH N
UNSAY	AH N S EY
UNSAYIMONG	AH N S EY AH M AH NG
UNTA	AH N T AA
UNTAG	AH N T AE G
UNUD	AH N AH D
UNUM	Y UW N AH M
UNUM(2)	UW N AH M
UNYA	AH N Y AA
UNYAHANGTUD	AH N Y AH HH AE N G T AH D
UNYANG	AH N Y AE NG
UNYAY	AH N Y EY IY
UPANG	Y UW P AH NG
UPAT	Y UW P AH T
UPLOAD	AH P L OW D
UPTOWN	AH P T AW N
URI	Y ER IY
US	AH S
US(2)	Y UW EH S
USA	Y UW EH S EY
USAB	Y UW S AH B
USAHAY	Y UW S AE HH EY IY
USAHON	Y UW S AH HH AH N
USANG	Y UW S AH NG
USAY	Y UW S EY IY
USBA	AH Z AH
USBON	AH Z AH N
USIK	Y UW S AH K
USO	Y UW S OW
USOB	Y UW S AH B
USWAG	AH S W AH G
UT	AH T
UTAN	Y UW T AH N
UTANG	Y UW T AH NG
UTIN	Y UW T AH N
UTLANAN	AH T L AH N AH N
UTOG	Y UW T AH G
UTOK	Y UW T AH K
UTOKAN	Y UW T OW K AH N
UTRO	AH T R OW
UTUK	Y UW T AH K
UUMA	Y UW AH M AH
UWAGAN	AH W AH JH AH N
UWAHI	AH W AH HH IY
UWAHINA	AH W AA HH AH N AH
UWAN	AH W AH N
UWAT	AH W AH T
UWAW	AH W AH
UY	UW IY
UY(2)	Y UW W AY
UYAB	Y UW AY AH B
UYAMOT	Y UW AY AH M AH T
UYOAN	Y UW AY OW AH N
UYON	Y UW AY AH N
VALERIE	V AE L ER IY
VALIDATION	V AE L AH D EY SH AH N
VAULT	V AO L T
VEDIOKIHAN	V IY D IY AA K AH AH N
VELASCO	V EH L AA S K OW
VERIFY	V EH R AH F AY
VICE	V AY S
VICENTE	V IY CH EH N T IY
VIDEOKE	V IH D IY OW K
VIDEOKEHAN	V AH D IY AA K AH AH N
VIDEOKIHAN	V AH D IY AA K AH AH N
VILLACAMPA	V IH L AH K AE M P AH
VILLAGONZALO	V IH L AH G AA N Z AH L OW
VILLAHERMOSA	V IH L AH HH AH R M AH S AH
VILLAR	V IH L ER
VILLARIN	V IH L ER IH N
VINA	V IY N AH
VITOR	V AY T AH R
VOLUNTEER	V AA L AH N T IH R
WA	W AA
WAGAS	W AE G AH Z
WAGTANGON	W AE G T AE NG AO N
WAIT	W EY T
WAIVER	W EY V ER
WALA	W AO L AH
WALANG	W AA L AH NG
WALAY	W AA L EY IY
WALAY	W AA L EY IY
WALO	W AA L OW
WALONG	W AA L AH NG
WANG	W AE NG
WARRANT	W AO R AH N T
WAY	W EY
WAYS	W EY Z
WHO	HH UW
WIKA	W IH K AH
WILKRIS	W IH L K R AH S
WOULD	W UH D
XRAY	Z R EY IY
Y 	IY
YAGPIS	Y AE G P AH S
YAMAHA	Y AA M AA HH AA
YAON	Y EY AH N
YARDA	Y AA R D AH
YASAY	Y AE S EY IY
YAWE	Y AO
YAWI	Y AO IY
YBAEZ	Y B IY Z
YEAR	Y IH R
YELO	Y EH L OW
YONG	Y AO NG
YOU	Y UW
YOUR	Y AO R
YOUR(2)	Y UH R
YUTA	Y UW T AH
YUTANG	Y UW T AH NG
Z	Z IY
ZAMBOANGA	Z AE M B OW NG G AH
ZAMORAS	Z AE M AH R AH Z
KWARENTAY	K W AH R EH N T EY IY
ABEINTE	EY B IY N T
ACTIVITY	AE K T IH V IH T IY
AQUINO	AH K IY N OW
ASAL	AH Z AH L
BALBANGAAN	B AE L B AE N G EY AH N
BALISBISAN	B AH L IH Z AH S AH N
BANANG	B AE N AH NG
BARILI	B AE R AH L IY
BATMAN	B AE T M AE N
BOUT	B AW T
CARMEN	K AA R M AH N
CASTRODES	K AE S T R OW D Z
COMELEC	K AH M EH L AH K
DASH	D AE SH
DINAKPAN	D AH N AE K AH N
DISCO	D IH S K OW
DISI	D AH S IY
DIYOTAYNG	D AY AY AH T EY NG
DOCTOR	D AA K T ER
DOCTOR(2)	D AO K T ER
ECONG	EH K AH NG
ESKINITA	EH S IH N AH T AH
FAITH	F EY TH
GACASAN	G AE K AH Z AH N
GATO	G AE T OW
GAWIN	G AO AH N
GERALDINE	JH EH R AH L D IY N
GIHASOK	JH IH HH AH S AH K
GIHISGUTAN	JH IH HH AH Z Y UW T AH N
GIKAAWAY	JH AH K AA W EY IY
GIKABLIT	JH AH K AE B L AH T
GILUGAKAN	JH AH L UW G AH K AH N
GINAGAWA	JH AH N AE G AH AH
GISAKAY	JH AH S AE K EY IY
GITANGTANG	JH AH T AE N G T AH NG
GITAPUK	JH IH T AH P AH K
GITUNOL	JH IH T Y UW N AH L
GRUPONG	G R UW P AH NG
HINGKIT	HH IY IH NG K IH T
HIPOSA	HH IH P AH S AH
HITANGKAAN	HH AH T AE N G K EY AH N
HOBBY	HH AA B IY
HUNSOY	HH AH N S OW IY
IKADISISAYS	IH K AH D IH S AH S EY Z
ILALOM	IH L AH L AH M
IMBESTIGAHAN	IH M B AH S T IH G AH AH N
IPROCLAIM	IH P R AH K L EY M
ISUGAALON	AH S UW G AH L AH N
JESUSITO	JH AH S UW S AH T OW
JUMOLA	JH UW M AH L AH
KABALAK	K AE B AH L AH K
KADALASANG	K AH D AE L AH S AH NG
KAINAN	K EY N AH N
KALAMBIGITAN	K AH L AE M B IH JH AH T AH N
KANATO	K AE N AH T OW
KAPAWAN	K AE P AH AH N
KATORSE	K AE T AH R S
KAUNORAN	K AO N AH R AH N
KILOMETRO	K IH L AH M EH T R OW
KREMIN	K R EH M AH N
LAMAY	L AE M EY
LIBO	L IH B OW
LIGHT	L AY T
LUGAWON	L AH G AH W AH N
MAA	M AA
MAAPSAN	M AA P S AH N
MAGAGANDANG	M AE G AH G AE N D AH NG
MAGKALAHUGAY	M AE G K AH L AH HH Y UW G EY IY
MAGPATAKAG	M AE G P AE T AH K AH G
MAHABILIN	M AH HH AE B AH L AH N
MAILANG	M EY L AH NG
MAKABALIBAD	M AE K AH B AE L AH B AH D
MAKABALIGYA	M AE K AH B AH L IH JH AY AH
MAKABUTO	M AE K AH B Y UW T OW
MAKAGAWAS	M AH K AE G AH AH Z
MAKAPASMO	M AE K AH P AE Z M OW
MALOLOS	M AH L AA L AH Z
MAPADAYON	M AE P AH D EY AO N
MASUKITSUKIT	M AH S UW K AH T S UW K AH T
MATINA	M AE T AH N AH
METERS	M IY T ER Z
MIAGDA	M AY AE G D AH
MIBANOS	M IH B AH N AH Z
MIBATI	M IH B AH T IY
MIBIYA	M AH B IY AY AH
MIG	M IH G
MM	EH M
MODALA	M AA D AH L AH
MOJARES	M AA JH AH R Z
NAGAUM	N AE G AH M
NAGDILAAB	N AE G D AH L AH B
NAGKADAIYANG	N AE G K AH D EY AY AH NG
NAGKALIDADES	N AE G K EY L AH D EY D Z
NAGPANILAP	N AE G P AE N AH L AH P
NAGPATUONG	N AE G P AE T Y UW AH NG
NAHANAW	N AE HH AH N AH
NAHINULONG	N AE HH AH N Y UW L AH NG
NAJARO	N AE JH AH R OW
NAKABALO	N AH K AE B AH L OW
NALAMBIT	N AH L AE M B AH T
NANILHIG	N AH N IH L HH AH G
NANION	N EY N IY AH N
NANULONG	N AE N Y UW L AH NG
NIBIYA	N AH B IY AY AH
NIDANGAT	N AH D AE N G AH T
NIDUGANG	N IH D Y UW G AH NG
NINOY	N IH N OW IY
NISAKAY	N AH S AE K EY IY
NITAHO	N IH T AH HH OW
NOTORYUS	N AH T AO R AY AH S
OF	AH V
ONSE	AA N S
ORDINARYONG	AO R D AH N AE R AY AH NG
PAGAWAS	P AE G AH AH Z
PAGDUDA	P AE G D Y UW D AH
PAGKULATA	P AE G K Y UW L AH T AH
PAGKUWESTYON	P AE G K AH W EH S T AY AH N
PAGPANLIMBASUG	P AE G P AH N L IH M B AH S AH G
PAGPANUMPA	P AE G P AH N AH M P AH
PAGPUK	P AE G P AH K
PAKPAK	P AE K AH K
PANAHONA	P AH N AE HH AH N AH
PANGI	P AE N JH IY
PANGIMOG	P AE N JH AH M AH G
PERO	P ER OW
PLAZA	P L AA Z AH
PLAZA(2)	P L AE Z AH
PUBLIC	P AH B L IH K
PUNTO	P UW N T OW
RAG	R AE G
RANDY	R AE N D IY
RECREATIONAL	R EH K R IY EY SH AH N AH L
SAGUBANGON	S AE G Y AH B AE N G AH N
SAIS	S EY Z
SANTA	S AE N T AH
SANTA(2)	S AE N AH
SIBUG	S IH B AH G
SIDECAR	S AY D K AA R
SIGNAL	S IH G N AH L
SINGKWENTAY	S IH N G K W EH N T EY IY
SIRA	S IH R AH
STOP	S T AA P
SUNGSONG	S AH NG S AO NG
SUNGSONGAN	S AH N G S AA N G AH N
TAGO	T AE G OW
TALISAY	T AH L IH S EY IY
TIGPAMABA	T IH G P AE M AH B AH
TINDERA	T IH N D AH R AH
TRESYENTO	T R EH S AY EH N T OW
ULAS	Y UW L AH Z
UNTANG	AH N T AE NG
BENTE	B EH N T
DINUNGGABAN	D AH N AH N G AH B AH N
FOURTH	F AO R TH
HILABI	HH IH L AH B IY
PESOS	P EY S OW Z
PILIPINO	P AH L IH P AH N OW
SETENTA	S AH T EH N T AH
THOUSAND	TH AW Z AH N D
THOUSAND(2)	TH AW Z AH N
THRITY	TH R IH T IY
IKABENTE	IH K AH B AH N T
SEIS	S IY S
